罢	罷	bà
吧	吧	bà
茇	茇	bàd
帛	帛	bàg
白	白	bàg
匐	匐	bàg
卜	蔔	bàg
稗	稗	bài
败	敗	bài
办	辦	bàn
扮	扮	bàn
蹦	蹦	bàng
绷	繃	bàng
笨	笨	bànt
钹	鈸	bàt
弼	弼	bàt
拔	拔	bàt
菝	菝	bàt
苾	苾	bàt
跋	跋	bàt
龅	齙	bàu
鲍	鮑	bàu
陛	陛	bày
币	幣	bày
弊	弊	bày
敝	敝	bày
毙	斃	bày
狴	狴	bày
坝	壩	bâ
霸	霸	bâ
捌	捌	bâd
八	八	bâd
佰	佰	bâg
百	百	bâg
伯	伯	bâg
拜	拜	bâi
扮	扮	bân
摈	擯	bânt
殡	殯	bânt
鬓	鬢	bânt
爆	爆	bâu
赑	贔	bây
蔽	蔽	bây
闭	閉	bây
钯	鈀	bã
把	把	bã
靶	靶	bã
摆	襬	bãi
摆	擺	bãi
捭	捭	bãi
舨	舨	bãn
版	版	bãn
坂	坂	bãn
板	闆	bãn
板	板	bãn
品	品	bãnt
禀	稟	bãnt
饱	飽	bãu
芭	芭	bä
笆	笆	bä
爸	爸	bä
葩	葩	bä
粑	粑	bä
疤	疤	bä
叭	叭	bä
巴	巴	bä
迫	迫	bäg/bëk
掰	掰	bäi/mâg
北	北	bäk
泵	泵	bämp
乓	乓	bämp/pöng
班	班	bän
斑	斑	bän
瘢	瘢	bän
颁	頒	bän
镚	鏰	bänk
崩	崩	bänk
斌	斌	bänt
彬	彬	bänt
缤	繽	bänt
宾	賓	bänt
奔	奔	bänt
滨	濱	bänt
槟	檳	bänt
濒	瀕	bänt/pant
筚	篳	bät
荜	蓽	bät
跸	蹕	bät
毕	畢	bät
笔	筆	bät
不	不	bät
哔	嗶	bät
钚	鈈	bät
胞	胞	bäu
孢	孢	bäu
鲍	鮑	bäu
包	包	bäu
苞	苞	bäu
褒	褒	bäu
跛	跛	bäy/bõ
呗	唄	bè
病	病	bèng/bènk
并	並	bènk
箆	箆	bèy
鼻	鼻	bèy
备	備	bèy
被	被	bèy
避	避	bèy
惫	憊	bèy/bài
柄	柄	bêng/bênk
迸	迸	bênk
并	併	bênk/pênk
秘	秘	bêy
庇	庇	bêy
辔	轡	bêy
铋	鉍	bêy
痹	痺	bêy
臂	臂	bêy
泌	泌	bêy
啤	啤	bë
逼	逼	bëk
碧	碧	bëk
壁	壁	bëk
璧	璧	bëk
愎	愎	bëk
冰	冰	bënk
兵	兵	bënk
乒	乒	bënk/pënk
碑	碑	bëy
悲	悲	bëy
裨	裨	bëy
卑	卑	bëy
屄	屄	bëy
蹩	蹩	bìd
别	別	bìd
瘪	癟	bìd
辩	辯	bìn
辨	辨	bìn
便	便	bìn
卞	卞	bìn
鳖	鱉	bîd
别	彆	bîd
憋	憋	bîd
变	變	bîn
觱	觱	bïd
必	必	bïd
辫	辮	bïn
边	邊	bïn
鞭	鞭	bïn
表	錶	bïu
标	標	bïu
镳	鑣	bïu
镖	鏢	bïu
飙	飆	bïu
膘	膘	bïu
彪	彪	bïu
箔	箔	bòg
礴	礴	bòg
铂	鉑	bòg
薄	薄	bòg
泊	泊	bòg
雹	雹	bòg
舶	舶	bòg/pâg
蹼	蹼	bòk
仆	僕	bòk
曝	曝	bòk
瀑	瀑	bòk
濮	濮	bòk
磅	磅	bòng
傍	傍	bòng
镑	鎊	bòng
步	步	bòw
捕	捕	bòw
部	部	bòw
暴	暴	bòw
哺	哺	bòw
簿	簿	bòw
埠	埠	bòw/fàw
簸	簸	bô
播	播	bô
博	博	bôg
亳	亳	bôg
膊	膊	bôg
驳	駁	bôg
搏	搏	bôg
缚	縛	bôg/fôg
甭	甭	bônk
怖	怖	bôw
报	報	bôw
埔	埔	bôw
布	布	bôw
布	佈	bôw
蒡	蒡	bõng
绑	綁	bõng
榜	榜	bõng
膀	膀	bõng
堡	堡	bõw
鸨	鴇	bõw
保	保	bõw
圃	圃	bõw
宝	寶	bõw
补	補	bõw
葆	葆	bõw
玻	玻	bö
菠	菠	bö
波	波	bö
卜	卜	bök
邦	邦	böng
梆	梆	böng
帮	幫	böng
晡	晡	böw
勃	勃	bùd
拨	撥	bùd
脖	脖	bùd
荸	荸	bùd
渤	渤	bùd
焙	焙	bùi
悖	悖	bùi
背	背	bùi
绊	絆	bùn
畔	畔	bùn
叛	叛	bùn
胖	胖	bùn
拌	拌	bùn
伴	伴	bùn/pũn
钵	缽	bûd
钡	鋇	bûi
辈	輩	bûi
背	揹	bûi
狈	狽	bûi
贝	貝	bûi
半	半	bûn
杯	杯	büi
般	般	bün
搬	搬	bün
匾	匾	bĩn
贬	貶	bĩn
扁	扁	bĩn
婊	婊	bĩu
表	表	bĩu
畚	畚	bũn
苯	苯	bũn
本	本	bũn
饼	餅	bẽng
秉	秉	bẽnk
炳	炳	bẽnk
饼	餅	bẽnk
丙	丙	bẽnk
屏	屏	bẽnk
妣	妣	bẽy
比	比	bẽy
彼	彼	bẽy
匕	匕	bẽy/bêy
搽	搽	ca
槎	槎	ca
垞	垞	ca
茬	茬	ca
查	查	ca
碴	碴	ca
茶	茶	ca
豺	豺	cai
柴	柴	cai
侪	儕	cai
蚕	蠶	cam
馋	饞	cam
惭	慚	cam
谗	讒	cam
沉	沉	camp
荨	蕁	camp
鲟	鱘	camp
寻	尋	camp
残	殘	can
橙	橙	cang/cãng
曾	曾	cank
层	層	cank
尘	塵	cant
陈	陳	cant
巢	巢	cau
遒	遒	caw
囚	囚	caw
筹	籌	caw
泅	泅	caw
仇	仇	caw
稠	稠	caw
踌	躊	caw
畴	疇	caw
惆	惆	caw
酬	酬	caw
俦	儔	caw
绸	綢	caw
齐	齊	cay
荠	薺	cay
輋	輋	ce
斜	斜	ce
邪	邪	ce
情	情	cenk
澂	澂	cenk
埕	埕	cenk
澄	澄	cenk
惩	懲	cenk
呈	呈	cenk
程	程	cenk
晴	晴	cenk
肠	腸	ceong
场	場	ceong
长	長	ceong
戕	戕	ceong
祥	祥	ceong
墙	牆	ceong
蔷	薔	ceong
详	詳	ceong
翔	翔	ceong
樯	檣	ceong
蹰	蹰	ceu
厨	廚	ceu/coy
荃	荃	ceun
全	全	ceun
辁	輇	ceun
痊	痊	ceun
醛	醛	ceun
筌	筌	ceun
泉	泉	ceun
诠	詮	ceun
存	存	ceun
传	傳	ceun
铨	銓	ceun
戳	戳	ceôg
绰	綽	ceôg
卓	卓	ceôg
呛	嗆	ceông
戗	戧	ceông
怅	悵	ceông
跄	蹌	ceông
炝	熗	ceông
唱	唱	ceông
倡	倡	ceông
畅	暢	ceông
抢	搶	ceõng
呛	嗆	ceöng
戗	戧	ceöng
窗	窗	ceöng
锵	鏘	ceöng
菖	菖	ceöng
伥	倀	ceöng
娼	娼	ceöng
鲳	鯧	ceöng
猖	猖	ceöng
昌	昌	ceöng
枪	槍	ceöng
伫	佇	ceú
署	署	ceú
柱	柱	ceú
储	儲	ceú
苎	苧	ceú
处	處	ceú
褚	褚	ceú
曙	曙	ceú
处	處	ceû
踅	踅	ceûd
猝	猝	ceûd
撮	撮	ceûd
爨	爨	ceûn
串	串	ceûn
窜	竄	ceûn
寸	寸	ceûn
吋	吋	ceûn
橱	櫥	ceü
躇	躇	ceü
蹿	躥	ceün
村	村	ceün
汆	汆	ceün
川	川	ceün
穿	穿	ceün
贮	貯	ceũ
杵	杵	ceũ
忖	忖	ceũn
喘	喘	ceũn
揣	揣	ceũn
撺	攛	ceũn/ceûn
辞	辭	ci
踟	踟	ci
茌	茌	ci
脐	臍	ci
迟	遲	ci
匙	匙	ci
持	持	ci
瓷	瓷	ci
祠	祠	ci
篪	篪	ci
驰	馳	ci
慈	慈	ci
糍	糍	ci
弛	弛	ci
墀	墀	ci
池	池	ci
词	詞	ci
磁	磁	ci
潜	潛	cim
前	前	cin
缠	纏	cin
钱	錢	cin
憔	憔	ciu
瞧	瞧	ciu
潮	潮	ciu
樵	樵	ciu
朝	朝	ciu
锄	鋤	co
材	材	coi
才	才	coi
财	財	coi
裁	裁	coi
床	床	cong
藏	藏	cong
虫	蟲	conk
从	從	conk
丛	叢	conk
松	松	conk
琮	琮	conk
重	重	conk
嗪	嗪	cont
螓	螓	cont
秦	秦	cont
驯	馴	cont
巡	巡	cont
旬	旬	cont
循	循	cont
曹	曹	cow
嘈	嘈	cow
槽	槽	cow
漕	漕	cow
徐	徐	coy
蜍	蜍	coy
锤	錘	coy
随	隨	coy
隋	隋	coy
滁	滁	coy
除	除	coy
捶	捶	coy
槌	槌	coy
鲗	鰂	càg
贼	賊	càg
锃	鋥	càng
岔	岔	câ
诧	詫	câ
杈	杈	câ
衩	衩	câ
姹	姹	câ
插	插	câb
锸	鍤	câb
擦	擦	câd
刷	刷	câd
察	察	câd
獭	獺	câd
刹	剎	câd/sâd
栅	柵	câg
策	策	câg
拆	拆	câg
册	冊	câg
虿	蠆	câi
忏	懺	câm
杉	杉	câm/säm
谶	讖	câmp/câm
璨	璨	cân
灿	燦	cân
衬	襯	cânt
龀	齔	cânt
趁	趁	cânt
肏	肏	câu
嗅	嗅	câw
臭	臭	câw
凑	湊	câw
糗	糗	câw
溴	溴	câw
切	切	cây
沏	沏	cây
砌	砌	cây
踩	踩	cãi
踹	踹	cãi
惨	慘	cãm
碜	磣	cãmp
寝	寢	cãmp
产	產	cãn
铲	鏟	cãn
哂	哂	cãnt
诊	診	cãnt
缜	縝	cãnt/jãnt
炒	炒	cãu
吵	吵	cãu
丑	醜	cãw
丑	丑	cãw
差	差	cä
叉	叉	cä
搋	搋	cäi
差	差	cäi
揣	揣	cäi
猜	猜	cäi
钗	釵	cäi
恻	惻	cäk
测	測	cäk
搀	攙	cäm
掺	摻	cäm
参	參	cäm
侵	侵	cämp
参	參	cämp/cäm
餐	餐	cän
撑	撐	cäng
瞠	瞠	cäng
嗔	嗔	cänt
瞋	瞋	cänt
亲	親	cänt
辑	輯	cäp
缉	緝	cäp
葺	葺	cäp
七	七	cät
漆	漆	cät
柒	柒	cät
钞	鈔	cäu
抄	抄	cäu
楸	楸	cäw
鳅	鰍	cäw
抽	抽	cäw
秋	鞦	cäw
秋	秋	cäw
栖	棲	cäy
妻	妻	cäy
凄	淒	cäy
悽	悽	cäy
赤	赤	cêg
尺	尺	cêg
呎	呎	cêg
秤	秤	cênk
称	稱	cênk
称	稱	cênk/cânk
车	車	cë
奢	奢	cë
叱	叱	cëk
敕	敕	cëk
斥	斥	cëk
戚	戚	cëk
彳	彳	cëk
清	清	cënk
氰	氰	cënk
称	稱	cënk
鲭	鯖	cënk
蜻	蜻	cënk
蛏	蟶	cënk
青	青	cënk/cëng
似	似	cí
恃	恃	cí
柿	柿	cí
践	踐	cín/jìn
帜	幟	cî
厕	廁	cî
炽	熾	cî
翅	翅	cî
赐	賜	cî
次	次	cî
刺	刺	cî
妾	妾	cîb
设	設	cîd
撤	撤	cîd
澈	澈	cîd
辙	轍	cîd
切	切	cîd
彻	徹	cîd
掣	掣	cîd
堑	塹	cîm
僭	僭	cîm
暹	暹	cîm/cïm
肖	肖	cîu
鞘	鞘	cîu
俏	俏	cîu
峭	峭	cîu
雌	雌	cï
嗤	嗤	cï
差	差	cï
哧	哧	cï
眵	眵	cï
螭	螭	cï
蚩	蚩	cï
笞	笞	cï
鸱	鴟	cï
跐	跐	cï
魑	魑	cï
疵	疵	cï
痴	癡	cï
签	簽	cïm
签	籤	cïm
纤	纖	cïm
歼	殲	cïm
千	韆	cïn
仟	仟	cïn
迁	遷	cïn
千	千	cïn
阡	阡	cïn
超	超	cïu
钊	釗	cïu
昭	昭	cïu
锹	鍬	cïu
坐	坐	có
重	重	cónk
挫	挫	cô
错	錯	cô
锉	銼	cô
错	錯	côg
菜	菜	côi
赛	賽	côi
蔡	蔡	côi
塞	塞	côi
创	創	công
躁	躁	côw
噪	噪	côw
糙	糙	côw
醋	醋	côw
燥	燥	côw
措	措	côw
操	操	côw/cöw
觑	覷	côy
趣	趣	côy
翠	翠	côy
啐	啐	côy
脆	脆	côy
焠	焠	côy/sòy
淬	淬	côy/sòy
楚	楚	cõ
础	礎	cõ
彩	綵	cõi
采	採	cõi
睬	睬	cõi
采	采	cõi
彩	彩	cõi
闯	闖	cõng
敞	敞	cõng
氅	氅	cõng
厂	廠	cõng
宠	寵	cõnk
冢	冢	cõnk
蠢	蠢	cõnt
草	草	cõw
娶	娶	cõy
取	取	cõy
揣	揣	cõy
搓	搓	cö
刍	芻	cö
磋	磋	cö
雏	雛	cö
初	初	cö
龊	齪	cök
蹴	蹴	cök
亍	亍	cök
畜	畜	cök
蹙	蹙	cök
矗	矗	cök
束	束	cök
簇	簇	cök
蓄	蓄	cök
促	促	cök
速	速	cök
簌	簌	cök
搐	搐	cök
触	觸	cök/jök
苍	蒼	cöng
沧	滄	cöng
伧	傖	cöng
舱	艙	cöng
仓	倉	cöng
创	創	cöng
疮	瘡	cöng
忡	忡	cönk
冲	衝	cönk
聪	聰	cönk
骢	驄	cönk
冲	沖	cönk
枞	樅	cönk
囱	囪	cönk
憧	憧	cönk
匆	匆	cönk
涌	涌	cönk
充	充	cönk
葱	蔥	cönk
春	春	cönt
出	齣	cöt
出	出	cöt
操	操	cöw
粗	粗	cöw
催	催	cöy
趋	趨	cöy
炊	炊	cöy
摧	摧	cöy
吹	吹	cöy
崔	崔	cöy
璀	璀	cöy/cõy
褫	褫	cĩ
跐	跐	cĩ
矢	矢	cĩ
豕	豕	cĩ
侈	侈	cĩ
耻	恥	cĩ
始	始	cĩ
齿	齒	cĩ
此	此	cĩ
谄	諂	cĩm
浅	淺	cĩn
悄	悄	cĩu
悄	悄	cĩu/cïu
且	且	cẽ
扯	扯	cẽ
逞	逞	cẽnk
拯	拯	cẽnk
骋	騁	cẽnk
请	請	cẽnk/cẽng
斫	斲	deôg
涿	涿	deôg
啄	啄	deôg
琢	琢	deôg
夺	奪	deùd
段	段	deùn
断	斷	deùn
缎	緞	deùn
断	斷	deùn/deûn
锻	鍛	deûn
煅	煅	deûn
端	端	deün
短	短	deũn
沓	沓	dàb
踏	踏	dàb
蹋	蹋	dàb
达	達	dàd
哒	噠	dàd
繨	繨	dàd
大	大	dài
特	特	dàk
氮	氮	dàm
淡	淡	dàm
澹	澹	dàm
淡	淡	dàm/tám
疍	疍	dàn
惮	憚	dàn
蛋	蛋	dàn
但	但	dàn
弹	彈	dàn
邓	鄧	dànk
瞪	瞪	dànk/dänk
炖	燉	dànt
突	突	dàt
凸	凸	dàt
窦	竇	dàw
痘	痘	dàw
逗	逗	dàw
豆	豆	dàw/dãw
悌	悌	dày
弟	弟	dày
隶	隸	dày
第	第	dày
递	遞	dày
棣	棣	dày
逮	逮	dày/dòi
掸	撢	dán
掸	撣	dán
耷	耷	dâb
答	答	dâb
瘩	瘩	dâb
搭	搭	dâb
靼	靼	dâd
妲	妲	dâd/tãn
带	帶	dâi
戴	戴	dâi
诞	誕	dân
旦	旦	dân
镫	鐙	dânk
凳	凳	dânk
磴	磴	dânk
斗	鬥	dâw
缔	締	dây
帝	帝	dây
碲	碲	dây
蒂	蒂	dây
谛	諦	dây
打	打	dã
歹	歹	dãi
胆	膽	dãm
弹	彈	dãn
等	等	dãnk
墩	墩	dãnt
陡	陡	dãw
斗	斗	dãw
蚪	蚪	dãw
抖	抖	dãw
底	底	dãy
骶	骶	dãy
诋	詆	dãy
柢	柢	dãy
邸	邸	dãy
抵	抵	dãy
呆	呆	däi
德	德	däk
得	得	däk
聃	聃	däm
儋	儋	däm
耽	耽	däm
眈	眈	däm
担	擔	däm
单	單	dän
丹	丹	dän
殚	殫	dän
郸	鄲	dän
噔	噔	dänk
灯	燈	dänk
蹬	蹬	dänk
登	登	dänk
兜	兜	däw
低	低	däy
籴	糴	dèg
笛	笛	dèg
敌	敵	dèk
狄	狄	dèk
翟	翟	dèk
迪	迪	dèk
涤	滌	dèk
啶	啶	dènk
定	定	dènk
地	地	dèy
碇	碇	dênk
锭	錠	dênk/dènk
订	訂	dênk/dènk
爹	爹	dë
嫡	嫡	dëk
滴	滴	dëk
的	的	dëk
町	町	dënk
仃	仃	dënk
汀	汀	dënk
丁	丁	dënk
盯	盯	dënk/dëng
钉	釘	dënk/dëng
叮	叮	dënk/dëng
喋	喋	dìb
蝶	蝶	dìb
鲽	鰈	dìb
谍	諜	dìb
叠	疊	dìb
碟	碟	dìb
牒	牒	dìb
耋	耋	dìd
秩	秩	dìd
迭	迭	dìd
淀	澱	dìn
佃	佃	dìn
电	電	dìn
靛	靛	dìn
甸	甸	dìn
奠	奠	dìn
殿	殿	dìn
垫	墊	dìn
调	調	dìu
掉	掉	dìu
跌	跌	dîd
踮	踮	dîm
店	店	dîm
惦	惦	dîm
玷	玷	dîm
垫	墊	dîn
钓	釣	dîu
吊	弔	dîu
吊	吊	dîu
掂	掂	dïm
颠	顛	dïn
巅	巔	dïn
癫	癲	dïn
碘	碘	dïn
刁	刁	dïu
貂	貂	dïu
丢	丟	dïu
碉	碉	dïu
叼	叼	dïu
凋	凋	dïu
雕	雕	dïu
鲷	鯛	dïu
惰	惰	dò
堕	墮	dò
驮	馱	dò
度	度	dòg
踱	踱	dòg
铎	鐸	dòg
袋	袋	dòi
黛	黛	dòi
叇	靆	dòi
代	代	dòi
玳	玳	dòi
待	待	dòi
岱	岱	dòi
甙	甙	dòi
怠	怠	dòi/tói
殆	殆	dòi/tói
读	讀	dòk
碡	碡	dòk
椟	櫝	dòk
犊	犢	dòk
毒	毒	dòk
渎	瀆	dòk
黩	黷	dòk
牍	牘	dòk
独	獨	dòk
髑	髑	dòk
宕	宕	dòng
荡	盪	dòng
荡	蕩	dòng
砀	碭	dòng
菪	菪	dòng
胴	胴	dònk
恸	慟	dònk
恫	恫	dònk
侗	侗	dònk
洞	洞	dònk
动	動	dònk
顿	頓	dònt
钝	鈍	dònt
遁	遁	dònt
沌	沌	dònt
盹	盹	dònt
吨	噸	dònt
渡	渡	dòw
悼	悼	dòw
盗	盜	dòw
稻	稻	dòw
杜	杜	dòw
导	導	dòw
道	道	dòw
度	度	dòw
镀	鍍	dòw
蹈	蹈	dòw
兑	兌	dòy
队	隊	dòy
当	當	dông
档	檔	dông
栋	棟	dônk
冻	凍	dônk
蠹	蠹	dôw
妒	妒	dôw
到	到	dôw
倒	倒	dôw
对	對	dôy
跺	跺	dõ
躲	躲	dõ
朵	朵	dõ/deãu
剁	剁	dõ/deôg
党	黨	dõng
挡	擋	dõng
董	董	dõnk
懂	懂	dõnk
踵	踵	dõnk
岛	島	dõw
睹	睹	dõw
赌	賭	dõw
倒	倒	dõw
捣	搗	dõw
堵	堵	dõw
多	多	dö
哆	哆	dö
笃	篤	dök
督	督	dök
当	當	döng
铛	鐺	döng
当	噹	döng
裆	襠	döng
氡	氡	dönk
东	東	dönk
咚	咚	dönk
冬	冬	dönk
蹲	蹲	dönt
墩	墩	dönt
惇	惇	dönt
敦	敦	dönt
咄	咄	döt
叨	叨	döw
嘟	嘟	döw
刀	刀	döw
都	都	döw
堆	堆	döy
点	點	dĩm
碘	碘	dĩn
垫	墊	dĩn
典	典	dĩn
屌	屌	dĩu
嗲	嗲	dẽ
鼎	鼎	dẽnk
酊	酊	dẽnk
顶	頂	dẽnk
欸	欸	ey
矾	礬	fan
蕃	蕃	fan
凡	凡	fan
繁	繁	fan
樊	樊	fan
烦	煩	fan
钒	釩	fan
藩	藩	fan
帆	帆	fan
梵	梵	fan/fàn
焚	焚	fant
坟	墳	fant
汾	汾	fant
浮	浮	faw
腓	腓	fey
肥	肥	fey
妨	妨	fong
防	防	fong
房	房	fong
缝	縫	fonk
冯	馮	fonk
逢	逢	fonk
缝	縫	fonk/fònk
扶	扶	fu
符	符	fu
乎	乎	fu
芙	芙	fu
犯	犯	fàn
饭	飯	fàn
范	范	fàn
范	範	fàn
瓣	瓣	fàn
分	分	fànt
份	份	fànt
乏	乏	fàt
阀	閥	fàt
筏	筏	fàt
罚	罰	fàt
伐	伐	fàt
佛	佛	fàt
阜	阜	fàw
吠	吠	fày
忿	忿	fánt
愤	憤	fánt
奋	奮	fánt
化	化	fâ
珐	琺	fâd
发	髮	fâd
发	發	fâd
法	法	fâd
筷	筷	fâi
傀	傀	fâi
块	塊	fâi
快	快	fâi
哙	噲	fâi
泛	泛	fân/fàn
贩	販	fân/fãn
训	訓	fânt
粪	糞	fânt
沸	沸	fây
狒	狒	fây
费	費	fây
废	廢	fây
肺	肺	fây
犯	犯	fãn
返	返	fãn
反	反	fãn
粉	粉	fãnt
否	否	fãw
花	花	fä
旛	旛	fän
番	番	fän
翻	翻	fän
幡	幡	fän
分	分	fänt
婚	婚	fänt
纷	紛	fänt
熏	熏	fänt
熏	燻	fänt
醺	醺	fänt
昏	昏	fänt
荤	葷	fänt
氛	氛	fänt
勋	勳	fänt
吩	吩	fänt
芬	芬	fänt
酚	酚	fänt
薰	薰	fänt
拂	拂	fät
囫	囫	fät
弗	弗	fät
忽	忽	fät
窟	窟	fät
笏	笏	fät
佛	彿	fät
惚	惚	fät
氟	氟	fät
晖	暉	fäy
挥	揮	fäy
辉	輝	fäy
徽	徽	fäy
撝	撝	fäy
啡	啡	fë
扉	扉	fëy
绯	緋	fëy
鲱	鯡	fëy
菲	菲	fëy
蜚	蜚	fëy
非	非	fëy
飞	飛	fëy
妃	妃	fëy
霏	霏	fëy
伏	伏	fòk
茯	茯	fòk
宓	宓	fòk
复	復	fòk
袱	袱	fòk
服	服	fòk
奉	奉	fònk
凤	鳳	fònk
俸	俸	fònk/fõnk
课	課	fô
货	貨	fô
攫	攫	fôg
霍	霍	fôg
放	放	fông
况	況	fông
讽	諷	fônk
伙	伙	fõ
伙	夥	fõ
火	火	fõ
颗	顆	fõ
幌	幌	fõng
晃	晃	fõng
恍	恍	fõng
仿	彷	fõng
访	訪	fõng
仿	仿	fõng
纺	紡	fõng
蝌	蝌	fö
科	科	fö
蝠	蝠	fök
覆	覆	fök
福	福	fök
辐	輻	fök
幅	幅	fök
馥	馥	fök
蝮	蝮	fök
复	複	fök
腹	腹	fök
芳	芳	föng
慌	慌	föng
坊	坊	föng
谎	謊	föng
肪	肪	föng
邡	邡	föng
方	方	föng
荒	荒	föng
风	風	fönk
丰	豐	fönk
蜂	蜂	fönk
封	封	fönk
疯	瘋	fönk
烽	烽	fönk
锋	鋒	fönk
峰	峰	fönk
枫	楓	fönk
丰	丰	fönk
腐	腐	fù
赴	赴	fù
仆	仆	fù
驸	駙	fù
鲋	鮒	fù
傅	傅	fù
讣	訃	fù
咐	咐	fù
负	負	fù
附	附	fù
辅	輔	fù
父	父	fù
付	付	fù
妇	婦	fú
戽	戽	fû
绔	絝	fû
富	富	fû
裤	褲	fû
库	庫	fû
副	副	fû
赋	賦	fû
阔	闊	fûd
晦	晦	fûi
悔	悔	fûi
诲	誨	fûi
孵	孵	fü
俘	俘	fü
枯	枯	fü
呼	呼	fü
麸	麩	fü
轷	軤	fü
肤	膚	fü
骷	骷	fü
敷	敷	fü
夫	夫	fü
孚	孚	fü
灰	灰	füi
恢	恢	füi
魁	魁	füi
诙	詼	füi
奎	奎	füi/kuäy
宽	寬	fün
欢	歡	fün
髋	髖	fün
獾	貛	fün
苦	苦	fũ
府	府	fũ
虎	虎	fũ
斧	斧	fũ
抚	撫	fũ
腑	腑	fũ
唬	唬	fũ
甫	甫	fũ
俯	俯	fũ
琥	琥	fũ
拊	拊	fũ
釜	釜	fũ
鲔	鮪	fũi
款	款	fũn
榧	榧	fẽy
诽	誹	fẽy
匪	匪	fẽy
翡	翡	fẽy
斐	斐	fẽy
悱	悱	fẽy
强	強	geòng
脚	腳	geôg
僵	殭	geöng
羌	羌	geöng
僵	僵	geöng
蜣	蜣	geöng
姜	薑	geöng
姜	姜	geöng
疆	疆	geöng
缰	韁	geöng
倦	倦	geùn
券	券	geûn
眷	眷	geûn
鄄	鄄	geûn
绢	絹	geûn
鹃	鵑	geün
蠲	蠲	geün
涓	涓	geün
娟	娟	geün
捐	捐	geün
卷	捲	geũn
卷	卷	geũn
郡	郡	guànt
珺	珺	guànt
倔	倔	guàt
掘	掘	guàt
崛	崛	guàt
篑	簣	guày
柜	櫃	guày
跪	跪	guày
馈	饋	guày
褂	褂	guâ
挂	掛	guâ
卦	卦	guâ
刮	刮	guâd
刮	颳	guâd
掴	摑	guâg
怪	怪	guâi
掼	摜	guân
惯	慣	guân
棍	棍	guânt
桂	桂	guây
季	季	guây
悸	悸	guây
癸	癸	guây
贵	貴	guây
瑰	瑰	guây
寡	寡	guã
柺	柺	guãi
蒯	蒯	guãi
拐	拐	guãi
滚	滾	guãnt
晷	晷	guãy
鬼	鬼	guãy
轨	軌	guãy
诡	詭	guãy
瓜	瓜	guä
呱	呱	guä
乖	乖	guäi
鳏	鰥	guän
关	關	guän
訇	訇	guänk
肱	肱	guänk
薨	薨	guänk
轰	轟	guänk
鲲	鯤	guänt
军	軍	guänt
鋆	鋆	guänt
纶	綸	guänt
筠	筠	guänt
均	均	guänt
锟	錕	guänt
钧	鈞	guänt
君	君	guänt
骨	骨	guät
橘	橘	guät
鲑	鮭	guäy
圭	圭	guäy
硅	硅	guäy
瑰	瑰	guäy
龟	龜	guäy
闺	閨	guäy
皈	皈	guäy
归	歸	guäy
虢	虢	guëk
隙	隙	guëk/kuënk
过	過	guô
国	國	guôg
郭	郭	guôg
帼	幗	guôg
腘	膕	guôg
廓	廓	guôg/kuôg
桄	桄	guông
果	果	guõ
裹	裹	guõ
诳	誑	guõng
广	廣	guõng
犷	獷	guõng
戈	戈	guö
胱	胱	guöng
光	光	guöng
桄	桄	guöng
炯	炯	guẽnk
迥	迥	guẽnk
近	近	gànt
疙	疙	gàt
旧	舊	gàw
价	價	gâ
架	架	gâ
驾	駕	gâ
嫁	嫁	gâ
假	假	gâ
稼	稼	gâ
咖	咖	gâ
胛	胛	gâb
郏	郟	gâb
岬	岬	gâb
夹	夾	gâb
荚	莢	gâb
饸	餄	gâb
袷	袷	gâb
颊	頰	gâb
钾	鉀	gâb
蛱	蛺	gâb
甲	甲	gâb
轧	軋	gâd
镉	鎘	gâg
格	格	gâg
胳	胳	gâg
嗝	嗝	gâg
隔	隔	gâg
膈	膈	gâg
骼	骼	gâg
革	革	gâg
介	介	gâi
解	解	gâi
届	屆	gâi
疥	疥	gâi
尬	尬	gâi
界	界	gâi
戒	戒	gâi
诫	誡	gâi
芥	芥	gâi
鉴	鑑	gâm
监	監	gâm
淦	淦	gâmp
赣	贛	gâmp
噤	噤	gâmp
禁	禁	gâmp
涧	澗	gân
间	間	gân
谏	諫	gân
更	更	gânk
艮	艮	gânt
靳	靳	gânt
觐	覲	gânt/gãnt
蛤	蛤	gâp
鸽	鴿	gâp
嘎	嘎	gât
铰	鉸	gâu
校	校	gâu
教	教	gâu
较	較	gâu
觉	覺	gâu
窖	窖	gâu
酵	酵	gâu/häu
究	究	gâw
柩	柩	gâw
疚	疚	gâw
救	救	gâw
咎	咎	gâw
够	夠	gâw
诟	詬	gâw
垢	垢	gâw
厩	廄	gâw
灸	灸	gâw
计	計	gây
继	繼	gây
髻	髻	gây
蓟	薊	gây
尕	尕	gã
贾	賈	gã
斝	斝	gã
假	假	gã
槚	檟	gã
架	架	gã
解	解	gãi
蚧	蚧	gãi/guãi
减	減	gãm
橄	橄	gãmp
敢	敢	gãmp
锦	錦	gãmp
感	感	gãmp
拣	揀	gãn
柬	柬	gãn
简	簡	gãn
茧	繭	gãn
碱	鹼	gãn
锏	鐧	gãn
哽	哽	gãnk
埂	埂	gãnk
梗	梗	gãnk
亘	亙	gãnk
耿	耿	gãnk
鲠	鯁	gãnk/kãnk
谨	謹	gãnt
紧	緊	gãnt
堇	堇	gãnt
仅	僅	gãnt
馑	饉	gãnt
瑾	瑾	gãnt
搞	搞	gãu
饺	餃	gãu
狡	狡	gãu
姣	姣	gãu
皎	皎	gãu
搅	攪	gãu
佼	佼	gãu
绞	絞	gãu
铰	鉸	gãu
苟	苟	gãw
韭	韭	gãw
枸	枸	gãw
玖	玖	gãw
九	九	gãw
久	久	gãw
狗	狗	gãw
纠	糾	gãw/dãw
珈	珈	gä
迦	迦	gä
加	加	gä
袈	袈	gä
伽	伽	gä
噶	噶	gä
嘉	嘉	gä
痂	痂	gä
镓	鎵	gä
家	傢	gä
枷	枷	gä
家	家	gä
佳	佳	gäi
阶	階	gäi
街	街	gäi
偕	偕	gäi
秸	秸	gäi
皆	皆	gäi
缄	緘	gäm
监	監	gäm
尴	尷	gäm/gâm
今	今	gämp
柑	柑	gämp
金	金	gämp
泔	泔	gämp
甘	甘	gämp
禁	禁	gämp
苷	苷	gämp
间	間	gän
艰	艱	gän
奸	奸	gän
奸	姦	gän
更	更	gäng
耕	耕	gäng
羹	羹	gänk
更	更	gänk
庚	庚	gänk
斤	斤	gänt
巾	巾	gänt
哏	哏	gänt
根	根	gänt
跟	跟	gänt
筋	筋	gänt
急	急	gäp
纥	紇	gät
吉	吉	gät
桔	桔	gät
讫	訖	gät
跤	跤	gäu
胶	膠	gäu
茭	茭	gäu
郊	郊	gäu
交	交	gäu
蛟	蛟	gäu
钩	鉤	gäw
佝	佝	gäw
阄	鬮	gäw
鸠	鳩	gäw/käw
鸡	雞	gäy
极	極	gèk
痉	痙	gènk
竞	競	gènk
劲	勁	gènk
忌	忌	gèy
伎	伎	gèy
技	技	gèy
芰	芰	gèy
妓	妓	gèy
镜	鏡	gêng
敬	敬	gênk
径	徑	gênk
劲	勁	gênk
径	逕	gênk
觊	覬	gêy
记	記	gêy
既	既	gêy
寄	寄	gêy
纪	紀	gêy
棘	棘	gëk
激	激	gëk
殛	殛	gëk
戟	戟	gëk
亟	亟	gëk
击	擊	gëk
惊	驚	gëng
矜	矜	gënk
经	經	gënk
泾	涇	gënk
兢	兢	gënk
荆	荊	gënk
惊	驚	gënk
京	京	gënk
矶	磯	gëy
犄	犄	gëy
姬	姬	gëy
畸	畸	gëy
讥	譏	gëy
奇	奇	gëy
箕	箕	gëy
乩	乩	gëy
基	基	gëy
饥	飢	gëy
叽	嘰	gëy
羁	覊	gëy
几	几	gëy
玑	璣	gëy
机	機	gëy
几	幾	gëy
肌	肌	gëy
畿	畿	gëy
杰	傑	gìd
桀	桀	gìd
俭	儉	gìm
键	鍵	gìn
件	件	gìn
健	健	gìn
撬	撬	gìu
轿	轎	gìu
劫	劫	gîb
结	結	gîd
拮	拮	gîd
洁	潔	gîd
剑	劍	gîm
见	見	gîn
建	建	gîn
腱	腱	gîn
叫	叫	gîu
搛	搛	gïm
兼	兼	gïm
鹣	鶼	gïm
犍	犍	gïn
肩	肩	gïn
坚	堅	gïn
骄	驕	gïu
娇	嬌	gïu
锔	鋦	gòk
局	局	gòk
焗	焗	gòk
共	共	gònk
诰	誥	gòw
惧	懼	gòy
飓	颶	gòy
讵	詎	gòy
苣	苣	gòy
遽	遽	gòy
具	具	gòy
巨	鉅	gòy
巨	巨	gòy
炬	炬	gòy
个	個	gô
葛	葛	gôd
割	割	gôd
各	各	gôg
角	角	gôg
搁	擱	gôg
阁	閣	gôg
觉	覺	gôg
盖	蓋	gôi
干	幹	gôn
钢	鋼	gông
杠	槓	gông
降	降	gông
绛	絳	gông
供	供	gônk
贡	貢	gônk
郜	郜	gôw
告	告	gôw
锆	鋯	gôw
踞	踞	gôy
据	據	gôy
句	句	gôy
锯	鋸	gôy/geô
改	改	gõi
擀	擀	gõn
杆	桿	gõn
赶	趕	gõn
港	港	gõng
讲	講	gõng
拱	拱	gõnk
巩	鞏	gõnk
珙	珙	gõnk
杲	杲	gõw
藁	藁	gõw
稿	稿	gõw
槁	槁	gõw
缟	縞	gõw
镐	鎬	gõw
龋	齲	gõy
举	舉	gõy
矩	矩	gõy
榉	櫸	gõy
蒟	蒟	gõy
莒	莒	gõy
歌	歌	gö
哥	哥	gö
仡	仡	gö
旮	旮	gö/gôg
菏	菏	gö/ho
咯	咯	gög
该	該	göi
赅	賅	göi
毂	轂	gök
菊	菊	gök
嚳	嚳	gök
鹄	鵠	gök
谷	穀	gök
掬	掬	gök
鞠	鞠	gök
梏	梏	gök
谷	谷	gök
竿	竿	gön
肝	肝	gön
杆	杆	gön
干	乾	gön
干	干	gön
纲	綱	göng
罡	罡	göng
刚	剛	göng
岗	崗	göng
冈	岡	göng
江	江	göng
缸	缸	göng
肛	肛	göng
弓	弓	gönk
工	工	gönk
功	功	gönk
宫	宮	gönk
公	公	gönk
躬	躬	gönk
龚	龔	gönk
供	供	gönk
恭	恭	gönk
蚣	蚣	gönk
攻	攻	gönk
睾	睾	göw
皋	皋	göw
羔	羔	göw
膏	膏	göw
高	高	göw
糕	糕	göw
据	据	göy
居	居	göy
雇	僱	gû
故	故	gû
顾	顧	gû
固	固	gû
锢	錮	gû
盥	盥	gûn
冠	冠	gûn
灌	灌	gûn
贯	貫	gûn
罐	罐	gûn
鹳	鸛	gûn
觚	觚	gü
咕	咕	gü
轱	軲	gü
蛄	蛄	gü
沽	沽	gü
姑	姑	gü
菇	菇	gü
辜	辜	gü
孤	孤	gü
棺	棺	gün
倌	倌	gün
莞	莞	gün
观	觀	gün
冠	冠	gün
官	官	gün
睑	瞼	gĩm
捡	撿	gĩm
检	檢	gĩm
矫	矯	gĩu
缴	繳	gĩu
古	古	gũ
估	估	gũ
钴	鈷	gũ
贾	賈	gũ
牯	牯	gũ
股	股	gũ
蛊	蠱	gũ
鼓	鼓	gũ
馆	館	gũn
管	管	gũn
脘	脘	gũn
莞	莞	gũn
颈	頸	gẽng
境	境	gẽnk
警	警	gẽnk
竟	竟	gẽnk
儆	儆	gẽnk
憬	憬	gẽnk
景	景	gẽnk
璟	璟	gẽnk
纪	紀	gẽy
己	己	gẽy
几	幾	gẽy
杞	杞	gẽy
遐	遐	ha
霞	霞	ha
瑕	瑕	ha
蛤	蛤	ha
骸	骸	hai
谐	諧	hai
鞋	鞋	hai
孩	孩	hai
函	函	ham
衔	銜	ham
咸	咸	ham
涵	涵	ham
咸	鹹	ham
酣	酣	hamp
晗	晗	hamp
含	含	hamp
娴	嫺	han
闲	閒	han
痫	癇	han
行	行	hang
桁	桁	hank
恒	恆	hank
衡	衡	hank
行	行	hank
痕	痕	hant
瘊	瘊	haw
篌	篌	haw
喉	喉	haw
侯	侯	haw
猴	猴	haw
奚	奚	hay
兮	兮	hay
鼷	鼷	hay
向	向	heông
向	嚮	heông
享	享	heõng
晌	晌	heõng
饷	餉	heõng
飨	饗	heõng
响	響	heõng
靴	靴	heö
乡	鄉	heöng
香	香	heöng
血	血	heûd
劝	勸	heûn
绚	絢	heûn
绻	綣	heûn
券	券	heûn
萱	萱	heün
喧	喧	heün
圈	圈	heün
埙	壎	heün
暄	暄	heün
畎	畎	heũn
犬	犬	heũn
荷	荷	ho
河	河	ho
何	何	ho
汗	汗	hon
韩	韓	hon
寒	寒	hon
邯	邯	hon
鼾	鼾	hon
降	降	hong
杭	杭	hong
航	航	hong
吭	吭	hong
行	行	hong
虹	虹	honk
洪	洪	honk
雄	雄	honk
红	紅	honk
鸿	鴻	honk
熊	熊	honk
讧	訌	honk/hônk
号	號	how
嚎	嚎	how
嗥	嗥	how
壕	壕	how
蠔	蠔	how
豪	豪	how
毫	毫	how
厦	廈	hà
暇	暇	hà
下	下	hà
夏	夏	hà
箧	篋	hàb
磕	磕	hàb
峡	峽	hàb
匣	匣	hàb
颌	頜	hàb
瞌	瞌	hàb
柙	柙	hàb
合	合	hàb
盒	盒	hàb
阖	闔	hàb
狎	狎	hàb
侠	俠	hàb/hàb
狭	狹	hàb/hâb
解	解	hài
懈	懈	hài
械	械	hài
邂	邂	hài/hái
馅	餡	hàm
陷	陷	hàm
撼	撼	hàmp
憾	憾	hàmp
限	限	hàn
行	行	hànk
杏	杏	hànk
悻	悻	hànk
幸	幸	hànk
幸	倖	hànk
恨	恨	hànt
辖	轄	hàt
龁	齕	hàt
瞎	瞎	hàt
纥	紇	hàt
劾	劾	hàt
阂	閡	hàt
檄	檄	hàt
核	核	hàt/wàt
傚	傚	hàu
效	效	hàu
校	校	hàu
効	効	hàu
鲎	鱟	hàw
后	后	hàw
候	候	hàw
逅	逅	hàw
后	後	hàw
系	系	hày
系	繫	hày
系	係	hày
獬	獬	hái
骇	駭	hái
蟹	蟹	hái
槛	檻	hám
颔	頷	hámp
厚	厚	háw
掐	掐	hâb
呷	呷	hâb
嗑	嗑	hâb
吓	嚇	hâg
客	客	hâg
喊	喊	hâm
瞰	瞰	hâmp
勘	勘	hâmp
磡	磡	hâmp
崁	崁	hâmp
嵌	嵌	hâmp/hàmp
孝	孝	hâu
吼	吼	hâw
坎	坎	hãmp
砍	砍	hãmp
肯	肯	hãnk
啃	啃	hãnk
恳	懇	hãnt
很	很	hãnt
狠	狠	hãnt
垦	墾	hãnt
考	考	hãu
拷	拷	hãu
巧	巧	hãu
口	口	hãw
虾	蝦	hä
哈	哈	hä
恰	恰	häb
洽	洽	häb
赫	赫	häg
嗨	嗨	häi
揩	揩	häi
黑	黑	häk
克	剋	häk
刻	刻	häk
可	可	häk
克	克	häk
氪	氪	häk
勘	勘	hämp
蚶	蚶	hämp
憨	憨	hämp
龛	龕	hämp
堪	堪	hämp
戡	戡	hämp
坑	坑	häng
夯	夯	häng
哼	哼	hänk
铿	鏗	hänk
亨	亨	hänk
茎	莖	hänk/gênk
乞	乞	hät
敲	敲	häu
哮	哮	häu
烤	烤	häu/hãu
齁	齁	häw
胫	脛	hénk/gênk
吃	吃	hêg
庆	慶	hênk
兴	興	hênk
磬	磬	hênk
罄	罄	hênk
戏	戲	hêy
汽	汽	hêy
气	氣	hêy
憩	憩	hêy
器	器	hêy
弃	棄	hêy
兴	興	hënk
卿	卿	hënk
氢	氫	hënk
兄	兄	hënk
馨	馨	hënk
轻	輕	hënk/hëng
熹	熹	hëy
希	希	hëy
嘻	嘻	hëy
唏	唏	hëy
欺	欺	hëy
欷	欷	hëy
浠	浠	hëy
嬉	嬉	hëy
醯	醯	hëy
羲	羲	hëy
禧	禧	hëy
烯	烯	hëy
稀	稀	hëy
牺	犧	hëy
曦	曦	hëy
熙	熙	hëy
嘿	嘿	hëy
惬	愜	hìb
协	協	hîb
胁	脅	hîb
怯	怯	hîb
歉	歉	hîb
挟	挾	hîb/hàb
歇	歇	hîd
蝎	蠍	hîd
芡	芡	hîm
欠	欠	hîm
献	獻	hîn
宪	憲	hîn
窍	竅	hîu/kîu
谦	謙	hïm
牵	牽	hïn
骞	騫	hïn
轩	軒	hïn
掀	掀	hïn
骁	驍	hïu
浇	澆	hïu
嚣	囂	hïu
枭	梟	hïu
鸮	鴞	hïu
侥	僥	hïu
橇	橇	hïu/côy
贺	賀	hò
荷	荷	hò
貉	貉	hòg
鹤	鶴	hòg
学	學	hòg
氦	氦	hòi
害	害	hòi
亥	亥	hòi
槲	槲	hòk
酷	酷	hòk
汗	汗	hòn
捍	捍	hòn
翰	翰	hòn
焊	焊	hòn
瀚	瀚	hòn
悍	悍	hòn
项	項	hòng
巷	巷	hòng/hõng
号	號	hòw
镐	鎬	hòw
皓	皓	hòw
灏	灝	hòw
浩	浩	hòw
昊	昊	hòw
旱	旱	hón
鞨	鞨	hôd
喝	喝	hôd
褐	褐	hôd
渴	渴	hôd
壳	殼	hôg
汉	漢	hôn
看	看	hôn
哄	哄	hônk
汞	汞	hônk
控	控	hônk
哄	鬨	hônk/hònk
烘	烘	hônk/hönk
犒	犒	hôw
好	好	hôw
耗	耗	hôw
去	去	hôy
可	可	hõ
嗬	嗬	hõ
坷	坷	hõ
岢	岢	hõ
海	海	hõi
凯	凱	hõi
铠	鎧	hõi
剀	剴	hõi
恺	愷	hõi
垲	塏	hõi
闿	闓	hõi
罕	罕	hõn
侃	侃	hõn
刊	刊	hõn/hön
慷	慷	hõng/kõng
恐	恐	hõnk
孔	孔	hõnk
好	好	hõw
栩	栩	hõy
诩	詡	hõy
许	許	hõy
煦	煦	hõy/hôy
诃	訶	hö
呵	呵	hö
苛	苛	hö
开	開	höi
咍	咍	höi
锎	鐦	höi
哭	哭	hök
糠	糠	höng
诓	誆	höng
劻	劻	höng
腔	腔	höng
匡	匡	höng
康	康	höng
眶	眶	höng/kuäng
筐	筐	höng/kuäng
凶	凶	hönk
汹	洶	hönk
胸	胸	hönk
崆	崆	hönk
空	空	hönk
匈	匈	hönk
凶	兇	hönk
箜	箜	hönk
蒿	蒿	höw
薅	薅	höw
盱	盱	höy
歔	歔	höy
虚	虛	höy
嘘	噓	höy
墟	墟	höy
吁	吁	höy
险	險	hĩm
谴	譴	hĩn
缱	繾	hĩn
显	顯	hĩn
遣	遣	hĩn
蚬	蜆	hĩn
晓	曉	hĩu
哼	哼	hǹg
喜	喜	hẽy
岂	豈	hẽy
囍	囍	hẽy
起	起	hẽy
着	著	jeòg
著	著	jeòg
象	象	jeòng
杖	杖	jeòng
仗	仗	jeòng
像	像	jeòng
橡	橡	jeòng
匠	匠	jeòng
丈	丈	jeòng
雀	雀	jeôg
着	著	jeôg
鹊	鵲	jeôg
爵	爵	jeôg
嚼	嚼	jeôg
斫	斫	jeôg
灼	灼	jeôg
酌	酌	jeôg
勺	勺	jeôg/ceôg
桌	桌	jeôg/ceôg
酱	醬	jeông
幛	幛	jeông
瘴	瘴	jeông
障	障	jeông
嶂	嶂	jeông
账	賬	jeông
将	將	jeông
胀	脹	jeông
涨	漲	jeông
帐	帳	jeông
仗	仗	jeông
桨	槳	jeõng
奖	獎	jeõng
掌	掌	jeõng
长	長	jeõng
蒋	蔣	jeõng
涨	漲	jeõng/jeông
彰	彰	jeöng
将	將	jeöng
章	章	jeöng
浆	漿	jeöng
张	張	jeöng
漳	漳	jeöng
璋	璋	jeöng
蟑	蟑	jeöng
獐	獐	jeöng
樟	樟	jeöng
鄣	鄣	jeöng
嫜	嫜	jeöng
住	住	jeù
箸	箸	jeù
绝	絕	jeùd
传	傳	jeùn
著	著	jeû
驻	駐	jeû
注	注	jeû
注	註	jeû
著	著	jeû
蛀	蛀	jeû
炷	炷	jeû
啜	啜	jeûd
掇	掇	jeûd
辍	輟	jeûd
拙	拙	jeûd
咄	咄	jeûd
茁	茁	jeûd
转	轉	jeûn
钻	鑽	jeûn
钻	鑽	jeûn/jeün
猪	豬	jeü
株	株	jeü
蛛	蛛	jeü
侏	侏	jeü
珠	珠	jeü
铢	銖	jeü
茱	茱	jeü
诛	誅	jeü
诸	諸	jeü
朱	朱	jeü
砖	磚	jeün
尊	尊	jeün
颛	顓	jeün
专	專	jeün
鳟	鱒	jeün/jeûn
镌	鐫	jeün/jônt
煮	煮	jeũ
主	主	jeũ
传	傳	jeũn
纂	纂	jeũn
转	轉	jeũn
嵖	嵖	jà
膪	膪	jà
袭	襲	jàb
闸	閘	jàb
习	習	jàb
杂	雜	jàb
什	什	jàb
隰	隰	jàb
集	集	jàb
泽	澤	jàg
择	擇	jàg
摘	摘	jàg
踯	躑	jàg
掷	擲	jàg
谪	謫	jàg
宅	宅	jàg
眦	眥	jài
寨	寨	jài
站	站	jàm
錾	鏨	jàm
暂	暫	jàm
鸩	鴆	jàmp
朕	朕	jàmp
栈	棧	jàn
绽	綻	jàn
撰	撰	jàn
馔	饌	jàn
赚	賺	jàn
挣	掙	jàng
赠	贈	jànk
阵	陣	jànt
侄	姪	jàt
窒	窒	jàt
桎	桎	jàt
蛰	蟄	jàt
蛭	蛭	jàt
嫉	嫉	jàt
疾	疾	jàt
岫	岫	jàw
宙	宙	jàw
纣	紂	jàw
就	就	jàw
袖	袖	jàw
鹫	鷲	jàw
骤	驟	jàw
冑	冑	jàw
滞	滯	jày
炸	炸	jâ
诈	詐	jâ
乍	乍	jâ
咋	咋	jâ
榨	榨	jâ
咤	咤	jâ
蚱	蚱	jâ/jâg
咂	咂	jâb
眨	眨	jâb
砸	砸	jâb
匝	匝	jâb
札	札	jâd
扎	扎	jâd
轧	軋	jâd
紮	紮	jâd
铡	鍘	jâd
拶	拶	jâd
啧	嘖	jâg
责	責	jâg
窄	窄	jâg
债	債	jâi
湛	湛	jâm
蘸	蘸	jâm
枕	枕	jâmp
浸	浸	jâmp
赞	讚	jân
赞	贊	jân
镇	鎮	jânt
震	震	jânt
圳	圳	jânt
振	振	jânt
赈	賑	jânt
罩	罩	jâu
昼	晝	jâw
绉	縐	jâw
皱	皺	jâw
奏	奏	jâw
揍	揍	jâw
咒	咒	jâw
祭	祭	jây
制	製	jây
掣	掣	jây
际	際	jây
霁	霽	jây
济	濟	jây
制	制	jây
斩	斬	jãm
崭	嶄	jãm
怎	怎	jãmp
枕	枕	jãmp
盏	盞	jãn
趱	趲	jãn
攒	攢	jãn
疹	疹	jãnt
轸	軫	jãnt/cãnt
爪	爪	jãu
找	找	jãu
走	走	jãw
帚	帚	jãw
肘	肘	jãw
酒	酒	jãw
济	濟	jãy
仔	仔	jãy
咱	咱	jä
糌	糌	jä
吒	吒	jä
渣	渣	jä
齇	齇	jä
楂	楂	jä
抓	抓	jä/jãu
赍	齎	jäi
斋	齋	jäi
侧	側	jäk
则	則	jäk
仄	仄	jäk
昃	昃	jäk
斟	斟	jämp
箴	箴	jämp
针	針	jämp
砧	砧	jämp
簪	簪	jämp
增	增	jänk
峥	崢	jänk
铮	錚	jänk
僧	僧	jänk
憎	憎	jänk
曾	曾	jänk
筝	箏	jänk
狰	猙	jänk/jäng
挣	掙	jänk/jäng
争	爭	jänk/jäng
睁	睜	jänk/jäng
珍	珍	jänt
胗	胗	jänt
真	真	jänt
汁	汁	jäp
执	執	jäp
质	質	jät
嘲	嘲	jäu
邹	鄒	jäw
辀	輈	jäw
周	週	jäw
揪	揪	jäw
诌	謅	jäw
州	州	jäw
周	周	jäw
舟	舟	jäw
诹	諏	jäw
洲	洲	jäw
陬	陬	jäw
挤	擠	jäy
剂	劑	jäy
齑	齏	jäy
跻	躋	jäy
谢	謝	jè
汐	汐	jèk
席	席	jèk
夕	夕	jèk
寂	寂	jèk
籍	籍	jèk
殖	殖	jèk
直	直	jèk
藉	藉	jèk
值	值	jèk
矽	矽	jèk
植	植	jèk
蓆	蓆	jèk/jèg
借	藉	jèk/jê
借	借	jèk/jê
郑	鄭	jèng/jènk
净	淨	jènk
静	靜	jènk
靖	靖	jènk
阱	阱	jènk/jèng
这	這	jé/jê
柘	柘	jê
借	借	jê
蔗	蔗	jê
只	隻	jêg
瘠	瘠	jêk
炙	炙	jêk/jêg
脊	脊	jêk/jêg
政	政	jênk
正	正	jênk
证	證	jênk
症	症	jênk
嗟	嗟	jë
遮	遮	jë
绩	績	jëk
积	積	jëk
即	即	jëk
织	織	jëk
迹	跡	jëk
鲫	鯽	jëk
职	職	jëk
陟	陟	jëk
稷	稷	jëk
渍	漬	jëk/jî
钲	鉦	jënk
症	癥	jënk
烝	烝	jënk
睛	睛	jënk
蒸	蒸	jënk
侦	偵	jënk
菁	菁	jënk
贞	貞	jënk
征	征	jënk
怔	怔	jënk
征	徵	jënk
正	正	jënk
祯	禎	jënk
精	精	jënk
旌	旌	jënk
晶	晶	jënk
字	字	jì
雉	雉	jì
治	治	jì
巳	巳	jì
伺	伺	jì
耜	耜	jì
嗣	嗣	jì
稚	稚	jì
祀	祀	jì
自	自	jì
俟	俟	jì
痔	痔	jì
饲	飼	jì
峙	峙	jì/cí
豸	豸	jì/jài
寺	寺	jì/jĩ
捷	捷	jìd
睫	睫	jìd
截	截	jìd
渐	漸	jìm
贱	賤	jìn
召	召	jìu
赵	趙	jìu
质	質	jî
志	誌	jî
痣	痣	jî
智	智	jî
挚	摯	jî
志	志	jî
致	緻	jî
至	至	jî
轾	輊	jî
致	致	jî
置	置	jî
踬	躓	jî
恣	恣	jî/cî
辄	輒	jîb
折	摺	jîb
楫	楫	jîb
褶	褶	jîb
接	接	jîb
浃	浹	jîb
嗫	囁	jîb
栉	櫛	jîd
婕	婕	jîd
折	折	jîd
节	節	jîd
哲	哲	jîd
蜇	蜇	jîd
疖	癤	jîd
浙	浙	jîd
占	佔	jîm
颤	顫	jîn
荐	薦	jîn
饯	餞	jîn
战	戰	jîn
溅	濺	jîn
箭	箭	jîn
诏	詔	jîu
照	照	jîu
氏	氏	jï
蜘	蜘	jï
脂	脂	jï
支	支	jï
枝	枝	jï
咨	咨	jï
滋	滋	jï
孜	孜	jï
兹	茲	jï
姿	姿	jï
淄	淄	jï
鼒	鼒	jï
资	資	jï
赀	貲	jï
知	知	jï
吱	吱	jï
谘	諮	jï
龇	齜	jï
芝	芝	jï
肢	肢	jï
辎	輜	jï
之	之	jï
唧	唧	jïd
瞻	瞻	jïm
尖	尖	jïm
詹	詹	jïm
谵	譫	jïm
霑	霑	jïm
沾	沾	jïm
占	占	jïm
煎	煎	jïn
笺	箋	jïn
膻	羶	jïn
毡	氈	jïn
招	招	jïu
椒	椒	jïu
蕉	蕉	jïu
焦	焦	jïu
礁	礁	jïu
朝	朝	jïu
唑	唑	jò
助	助	jò
坐	坐	jò
座	座	jò
凿	鑿	jòg
擢	擢	jòg
在	在	jòi
镯	鐲	jòk
轴	軸	jòk
续	續	jòk
妯	妯	jòk
族	族	jòk
躅	躅	jòk
俗	俗	jòk
逐	逐	jòk
浊	濁	jòk
镞	鏃	jòk
藏	藏	jòng
脏	臟	jòng
撞	撞	jòng
状	狀	jòng
奘	奘	jòng
颂	頌	jònk
重	重	jònk
讼	訟	jònk
诵	誦	jònk
仲	仲	jònk
烬	燼	jònt
尽	盡	jònt
造	造	jòw
皂	皂	jòw
做	做	jòw
慥	慥	jòw/côw
屿	嶼	jòy
罪	罪	jòy
序	序	jòy
坠	墜	jòy
叙	敘	jòy
聚	聚	jòy
溆	漵	jòy
缀	綴	jòy/jôy
佐	佐	jô
诅	詛	jô/jõ
作	作	jôg
昨	昨	jôg/jòg
载	載	jôi
再	再	jôi
壮	壯	jông
葬	葬	jông
戆	戇	jông/ngòng
中	中	jônk
种	種	jônk
众	眾	jônk
纵	縱	jônk
粽	粽	jônk/jõnk
缙	縉	jônt
进	進	jônt
俊	俊	jônt
竣	竣	jônt
骏	駿	jônt
峻	峻	jônt
晋	晉	jônt
灶	灶	jôw
醉	醉	jôy
惴	惴	jôy
赘	贅	jôy
最	最	jôy
左	左	jõ
俎	俎	jõ
阻	阻	jõ
宰	宰	jõi
崽	崽	jõi
载	載	jõi
驵	駔	jõng
总	總	jõnk
种	種	jõnk
肿	腫	jõnk
准	準	jõnt
尽	儘	jõnt
准	准	jõnt
隼	隼	jõnt
早	早	jõw
澡	澡	jõw
组	組	jõw
蚤	蚤	jõw
藻	藻	jõw
祖	祖	jõw
驵	駔	jõw
枣	棗	jõw
龃	齟	jõy
咀	咀	jõy
嘴	嘴	jõy
沮	沮	jõy
栽	栽	jöi
灾	災	jöi
哉	哉	jöi
竹	竹	jök
瞩	矚	jök
烛	燭	jök
捉	捉	jök
粥	粥	jök
祝	祝	jök
足	足	jök
竺	竺	jök
筑	築	jök
嘱	囑	jök
脏	髒	jöng
装	裝	jöng
赃	贓	jöng
妆	妝	jöng
桩	樁	jöng
庄	莊	jöng
中	中	jönk
终	終	jönk
纵	縱	jönk
盅	盅	jönk
宗	宗	jönk
枞	樅	jönk
钟	鐘	jönk
踪	蹤	jönk
螽	螽	jönk
棕	棕	jönk
钟	鍾	jönk
忠	忠	jönk
鬃	鬃	jönk
衷	衷	jönk/cönk
综	綜	jönk/jônk
臻	臻	jönt
津	津	jönt
樽	樽	jönt
榛	榛	jönt
谆	諄	jönt
遵	遵	jönt/jeün
怵	怵	jöt
黜	黜	jöt
卒	卒	jöt
糟	糟	jöw
租	租	jöw
遭	遭	jöw
狙	狙	jöy
追	追	jöy
锥	錐	jöy
椎	椎	jöy
蛆	蛆	jöy/cöy
秭	秭	jĩ
止	止	jĩ
只	只	jĩ
指	指	jĩ
纸	紙	jĩ
子	子	jĩ
芷	芷	jĩ
趾	趾	jĩ
酯	酯	jĩ
祉	祉	jĩ
仔	仔	jĩ
姊	姊	jĩ
咫	咫	jĩ
旨	旨	jĩ
滓	滓	jĩ
籽	籽	jĩ
址	址	jĩ
紫	紫	jĩ
梓	梓	jĩ
展	展	jĩn
辗	輾	jĩn
碾	碾	jĩn
剪	剪	jĩn
翦	翦	jĩn
阐	闡	jĩn/cĩn
沼	沼	jĩu
剿	剿	jĩu
者	者	jẽ
姐	姐	jẽ
整	整	jẽnk
井	井	jẽnk/jẽng
擒	擒	kamp
琴	琴	kamp
噙	噙	kamp
禽	禽	kamp
勤	勤	kant
芹	芹	kant
毬	毬	kaw
裘	裘	kaw
求	求	kaw
球	球	kaw
仇	仇	kaw
虬	虯	kaw
逑	逑	kaw
犰	犰	kaw
瘸	瘸	ke
骑	騎	ke
鲸	鯨	kenk
黥	黥	kenk
琼	瓊	kenk
擎	擎	kenk
强	強	keong
权	權	keun
蜷	蜷	keun
颧	顴	keun
拳	拳	keun
鬈	鬈	keun
俟	俟	key
鳍	鰭	key
耆	耆	key
旗	旗	key
奇	奇	key
岐	岐	key
期	期	key
祺	祺	key
祁	祁	key
棋	棋	key
蕲	蘄	key
琪	琪	key
旂	旂	key
琦	琦	key
歧	歧	key
淇	淇	key
祈	祈	key
其	其	key
萁	萁	key
麒	麒	key
噱	噱	keòg
强	強	keóng
羟	羥	keóng
却	卻	keôg
撅	撅	keûd
厥	厥	keûd
孓	孓	keûd
蕨	蕨	keûd
蹶	蹶	keûd
阙	闕	keûd
诀	訣	keûd
决	決	keûd
獗	獗	keûd
缺	缺	keûd
抉	抉	keûd
橛	橛	keûd/geùd
钳	鉗	kim
黔	黔	kim
犍	犍	kin
乾	乾	kin
虔	虔	kin
掮	掮	kin
荞	蕎	kiu
桥	橋	kiu
侨	僑	kiu
乔	喬	kiu
翘	翹	kiu
邛	邛	konk
穹	穹	konk
穷	窮	konk
衢	衢	koy
蠼	蠼	koy
瞿	瞿	koy
朐	朐	koy
渠	渠	koy
璩	璩	koy
群	群	kuant
裙	裙	kuant
暌	暌	kuay
睽	睽	kuay
携	攜	kuay
畦	畦	kuay
夔	夔	kuay
葵	葵	kuay
喹	喹	kuay
馗	馗	kuay
揆	揆	kuay/kuáy
狂	狂	kuong
愧	愧	kuáy
跨	跨	kuâ
挎	挎	kuâ
胯	胯	kuâ
逛	逛	kuâng
窘	窘	kuânt
困	困	kuânt
困	睏	kuânt
侉	侉	kuã
菌	菌	kuãnt
捆	捆	kuãnt
垮	垮	kuä
夸	夸	kuä
夸	誇	kuä
框	框	kuäng/höng
髡	髡	kuänt
坤	坤	kuänt
昆	昆	kuänt
昆	崑	kuänt
焜	焜	kuänt/wànt
规	規	kuäy
窥	窺	kuäy
盔	盔	kuäy
岿	巋	kuäy
亏	虧	kuäy
扩	擴	kuôg
旷	曠	kuông
矿	礦	kuông/kông
邝	鄺	kuông/kông
及	及	kàp
芨	芨	kàp/gäp
妗	妗	kámp
近	近	kánt
舅	舅	káw/kâw
臼	臼	káw/kâw
髂	髂	kâ
揢	揢	kâg
咯	咯	kâg
靠	靠	kâu
铐	銬	kâu
蔻	蔻	kâw
扣	扣	kâw
寇	寇	kâw
叩	叩	kâw
扣	釦	kâw
媾	媾	kâw/gâw
构	構	kâw/gâw
购	購	kâw/gâw
契	契	kây
卡	卡	kã
楷	楷	kãi
蒈	蒈	kãi
锴	鍇	kãi/gäi
启	啟	kãy
喀	喀	kä
卡	卡	kä
襟	襟	kämp
给	給	käp
级	級	käp
歙	歙	käp
吸	吸	käp
岌	岌	käp
汲	汲	käp
笈	笈	käp
卡	卡	kät
咳	咳	kät
抠	摳	käw
篝	篝	käw/gäw
沟	溝	käw/gäw
稽	稽	käy
溪	溪	käy
蹊	蹊	käy
嵇	嵇	käy/hay
剧	劇	kèg
屐	屐	kèg
企	企	kéy
暨	暨	kêy
骥	驥	kêy
冀	冀	kêy
倾	傾	kënk
蹊	蹊	këy
崎	崎	këy
跷	蹺	kíu
诘	詰	kîd
锲	鍥	kîd
黠	黠	kîd
孑	孑	kîd
揭	揭	kîd
颉	頡	kîd
羯	羯	kîd
竭	竭	kîd
撷	擷	kîd/gîd
翘	翹	kîu/hîu
跷	蹺	kïu/hïu
拒	拒	kóy
距	距	kóy
郝	郝	kôg
涸	涸	kôg
恪	恪	kôg
壑	壑	kôg
榷	榷	kôg
悫	慤	kôg
确	確	kôg
欬	欬	kôi
钙	鈣	kôi
慨	慨	kôi
盖	蓋	kôi
概	概	kôi
忾	愾	kôi
溉	溉	kôi
丐	丐	kôi
伉	伉	kông
抗	抗	kông
闶	閌	kông
炕	炕	kông
扩	擴	kông
亢	亢	kông
曲	麴	kök
曲	曲	kök
扛	扛	köng
拘	拘	köy
驹	駒	köy
祛	祛	köy
俱	俱	köy
区	區	köy
岖	嶇	köy
躯	軀	köy
驱	驅	köy
聒	聒	kûd
括	括	kûd
蛞	蛞	kûd
豁	豁	kûd
箍	箍	kü
聩	聵	kũi
桧	檜	kũi
浍	澮	kũi
郐	鄶	kũi
绘	繪	kũi
侩	儈	kũi
狯	獪	kũi
溃	潰	kũi
贿	賄	kũi
刽	劊	kũi
鲙	鱠	kũi
脍	膾	kũi
会	會	kũi/wùi
茄	茄	kẽ
顷	頃	kẽnk
褴	襤	lam
篮	籃	lam
婪	婪	lam
蓝	藍	lam
岚	嵐	lam
临	臨	lamp
霖	霖	lamp
琳	琳	lamp
淋	淋	lamp
林	林	lamp
啉	啉	lamp
斓	斕	lan
栏	欄	lan
拦	攔	lan
阑	闌	lan
澜	瀾	lan
襕	襴	lan
兰	蘭	lan
骝	騮	law
留	留	law
螻	螻	law
楼	樓	law
刘	劉	law
浏	瀏	law
榴	榴	law
娄	婁	law
流	流	law
琉	琉	law
硫	硫	law
捞	撈	law
髅	髏	law
偻	僂	law
瘤	瘤	law
黎	黎	lay
犁	犁	lay
犂	犂	lay
藜	藜	lay
蠡	蠡	lay/láy
羚	羚	lenk
铃	鈴	lenk
菱	菱	lenk
灵	靈	lenk
翎	翎	lenk
棱	稜	lenk
鲮	鯪	lenk
玲	玲	lenk
囹	囹	lenk
凌	凌	lenk
龄	齡	lenk
聆	聆	lenk
陵	陵	lenk
令	令	lenk
伶	伶	lenk
蛉	蛉	lenk
绫	綾	lenk
呤	呤	lenk
苓	苓	lenk
櫺	櫺	lenk
零	零	lenk
凉	涼	leong
量	量	leong
粮	糧	leong
粱	粱	leong
莨	莨	leong
良	良	leong
梁	梁	leong
峦	巒	leun
挛	攣	leun
孪	孿	leun
联	聯	leun
栾	欒	leun
滦	灤	leun
鸾	鸞	leun
罹	罹	ley
狸	狸	ley
璃	璃	ley
蜊	蜊	ley
漓	漓	ley
鲡	鱺	ley
梨	梨	ley
厘	釐	ley
篱	籬	ley
缡	縭	ley
离	離	ley
略	略	leòg
掠	掠	leòg
辆	輛	leòng
亮	亮	leòng
谅	諒	leòng
量	量	leòng
踉	踉	leòng
魉	魎	leóng
俩	倆	leóng
两	兩	leóng
两	兩	leõng
乱	亂	leùn
捋	捋	leûd
劣	劣	leûd/leùd
恋	戀	leũn
脔	臠	leũn/leun
镰	鐮	lim
廉	廉	lim
帘	簾	lim
帘	帘	lim
链	鏈	lin
怜	憐	lin
涟	漣	lin
莲	蓮	lin
连	連	lin
缭	繚	liu
嘹	嘹	liu
寥	寥	liu
獠	獠	liu
聊	聊	liu
辽	遼	liu
僚	僚	liu
寮	寮	liu
镣	鐐	liu
燎	燎	liu
撩	撩	liu
疗	療	liu
瞭	瞭	liu
锣	鑼	lo
箩	籮	lo
罗	羅	lo
逻	邏	lo
猡	玀	lo
萝	蘿	lo
螺	螺	lo/lõ
徕	徠	loi
来	來	loi
涞	淶	loi
崃	崍	loi
莱	萊	loi
莨	莨	long
狼	狼	long
螂	螂	long
锒	鋃	long
琅	瑯	long
郎	郎	long
廊	廊	long
榔	榔	long
胧	朧	lonk
茏	蘢	lonk
聋	聾	lonk
咙	嚨	lonk
窿	窿	lonk
昽	曨	lonk
珑	瓏	lonk
笼	籠	lonk
龙	龍	lonk
隆	隆	lonk
眬	矓	lonk
囵	圇	lont
邻	鄰	lont
纶	綸	lont
论	論	lont
磷	磷	lont
遴	遴	lont
麟	麟	lont
粼	粼	lont
嶙	嶙	lont
轮	輪	lont
伦	倫	lont
仑	崙	lont
抡	掄	lont
璘	璘	lont
沦	淪	lont
仑	侖	lont
鳞	鱗	lont
胪	臚	low
痨	癆	low
颅	顱	low
卢	盧	low
炉	爐	low
庐	廬	low
劳	勞	low
牢	牢	low
醪	醪	low
芦	蘆	low
轳	轤	low
泸	瀘	low
鲈	鱸	low
唠	嘮	low
羸	羸	loy
镭	鐳	loy
驴	驢	loy
闾	閭	loy
擂	擂	loy
累	纍	loy
榈	櫚	loy
雷	雷	loy
缧	縲	loy
嫘	嫘	loy
骡	騾	loy/lo
立	立	làb
蜡	蠟	làb
垃	垃	làb
砬	砬	làb
腊	臘	làb
邋	邋	làb/làd
辣	辣	làd
拉	拉	làd
赖	賴	lài
籁	籟	lài
落	落	lài
肋	肋	làk/làg
鳓	鰳	làk/làg
勒	勒	làk/làg
舰	艦	làm
缆	纜	làm
滥	濫	làm
烂	爛	làn
遛	遛	làw
漏	漏	làw
蹓	蹓	làw
镂	鏤	làw
馏	餾	làw
溜	溜	làw
陋	陋	làw
励	勵	lày
丽	麗	lày
俪	儷	lày
荔	荔	lày
砺	礪	lày
蛎	蠣	lày
厉	厲	lày
例	例	lày
榄	欖	lám
览	覽	lám
揽	攬	lám
懔	懍	lámp
凛	凜	lámp
懒	懶	lán
冷	冷	láng
柳	柳	láw
篓	簍	láw
醴	醴	láy
礼	禮	láy
鳢	鱧	láy
澧	澧	láy
喇	喇	lâ
癞	癩	lâi
搂	摟	lãw
拉	拉	lä
喇	喇	lä
啦	啦	lä
拉	拉	läi
笠	笠	läp
甩	甩	lät
喽	嘍	läw
历	歷	lèk
历	曆	lèk
力	力	lèk
令	令	lènk
愣	愣	lènk
另	另	lènk
痢	痢	lèy
莅	蒞	lèy
吏	吏	lèy
莉	莉	lèy
俐	俐	lèy
利	利	lèy
猁	猁	lèy
岭	嶺	lénk/léng
领	領	lénk/léng
理	理	léy
逦	邐	léy
鲤	鯉	léy
娌	娌	léy
李	李	léy
履	履	léy
俚	俚	léy
里	里	léy
锂	鋰	léy
哩	哩	léy/yënk/léy
靓	靚	lêng
哩	哩	lë
咧	咧	lë
砾	礫	lëk
枥	櫪	lëk
雳	靂	lëk
沥	瀝	lëk/lèk
喱	喱	lëy
璃	璃	lëy
鬣	鬣	lìb
猎	獵	lìb
捩	捩	lìd
冽	冽	lìd
列	列	lìd
裂	裂	lìd
烈	烈	lìd
裣	襝	lìm
敛	斂	lìm
练	練	lìn
炼	煉	lìn
廖	廖	lìu
尥	尥	lìu
料	料	lìu
殓	殮	lím
脸	臉	lím
辇	輦	lín
撵	攆	lín
了	了	líu
了	瞭	líu
潦	潦	líu/lĩu
哩	哩	lï
令	令	lïm
撂	撂	lïu
溜	溜	lïu
撩	撩	lïu
乐	樂	lòg
落	落	lòg
赉	賚	lòi
睐	睞	lòi
耒	耒	lòi/lòy
戮	戮	lòk
鹿	鹿	lòk
陆	陸	lòk
禄	祿	lòk
漉	漉	lòk
氯	氯	lòk
六	六	lòk
录	錄	lòk
绿	綠	lòk
碌	碌	lòk
浪	浪	lòng
蒗	蒗	lòng
晾	晾	lòng
阆	閬	lòng/long
弄	弄	lònk
蔺	藺	lònt
吝	吝	lònt
躏	躪	lònt
论	論	lònt
律	律	lòt
栗	栗	lòt
篥	篥	lòt
栗	慄	lòt
率	率	lòt
鹬	鷸	lòt
溧	溧	lòt
傈	傈	lòt
路	路	lòw
赂	賂	lòw
辂	輅	lòw
潞	潞	lòw
嫪	嫪	lòw
露	露	lòw
璐	璐	lòw
涝	澇	lòw
劳	勞	lòw
鹭	鷺	lòw
泪	淚	lòy
滤	濾	lòy
戾	戾	lòy
漯	漯	lòy
虑	慮	lòy
类	類	lòy
累	累	lòy
朗	朗	lóng
拢	攏	lónk
垄	壟	lónk
笼	籠	lónk
陇	隴	lónk
虏	虜	lów
老	老	lów
姥	姥	lów
掳	擄	lów
鲁	魯	lów
卤	滷	lów
卤	鹵	lów
橹	櫓	lów
累	累	lóy
屡	屢	lóy
里	裡	lóy
垒	壘	lóy
褛	褸	lóy
铝	鋁	lóy
缕	縷	lóy
儡	儡	lóy
磊	磊	lóy
膂	膂	lóy
侣	侶	lóy
吕	呂	lóy
旅	旅	lóy
蕾	蕾	lóy/loy
络	絡	lôg
珞	珞	lôg
铬	鉻	lôg
酪	酪	lôg
饹	餎	lôg
烙	烙	lôg
骆	駱	lôg/lòg
洛	洛	lôg/lòg
裸	裸	lõ
郎	郎	lõng
卵	卵	lõnt
佬	佬	lõw
囉	囉	lö
咯	咯	lö
旯	旯	lö/lôg
麓	麓	lök
碌	碌	lök
辘	轆	lök
啷	啷	löng
捞	撈	löw
噜	嚕	löw
咧	咧	lẽ
麻	痲	ma
蟆	蟆	ma
麻	麻	ma
埋	埋	mai
霾	霾	mai/may
馒	饅	man
蛮	蠻	man
鳗	鰻	man
谩	謾	man
蔓	蔓	man
盲	盲	mang
盟	盟	mank
萌	萌	mank
岷	岷	mant
珉	珉	mant
氓	氓	mant
旻	旻	mant
苠	苠	mant
缗	緡	mant
雯	雯	mant
纹	紋	mant
玟	玟	mant
文	文	mant
民	民	mant
忞	忞	mant
闻	聞	mant
茅	茅	mau
矛	矛	mau
谋	謀	maw
牟	牟	maw
眸	眸	maw
缪	繆	maw
迷	迷	may
眯	瞇	may
醚	醚	may
谜	謎	may
溟	溟	menk
洺	洺	menk
螟	螟	menk
名	名	menk
鸣	鳴	menk
冥	冥	menk
明	明	menk
暝	暝	menk/mènk
瞑	瞑	menk/ménk
铭	銘	menk/ménk
靡	靡	mey
薇	薇	mey
蘼	蘼	mey
麋	麋	mey
楣	楣	mey
湄	湄	mey
微	微	mey
眉	眉	mey
嵋	嵋	mey
弥	瀰	mey/ney
猕	獼	mey/ney
绵	綿	min
棉	棉	min
眠	眠	min
瞄	瞄	miu
苗	苗	miu
描	描	miu
磨	磨	mo
蘑	蘑	mo
馍	饃	mo
莽	莽	mong
茫	茫	mong
虻	虻	mong
忘	忘	mong
芒	芒	mong
忙	忙	mong
亡	亡	mong
铓	鋩	mong
氓	氓	mong
檬	檬	monk
蒙	濛	monk
蒙	蒙	monk
蒙	矇	monk
曚	曚	monk
朦	朦	monk
无	無	mow
芜	蕪	mow
毛	毛	mow
诬	誣	mow
膜	膜	mow
毋	毋	mow
巫	巫	mow
谟	謨	mow
模	模	mow
髦	髦	mow
摹	摹	mow
牦	氂	mow/ley
霉	霉	mui
梅	梅	mui
枚	枚	mui
玫	玫	mui
煤	煤	mui
媒	媒	mui
酶	酶	mui
莓	莓	mui
门	門	mun
瞒	瞞	mun
扪	捫	mun
们	們	mun
鞔	鞔	mun
骂	罵	mà
卖	賣	mài
迈	邁	mài
陌	陌	màk
貘	貘	màk
蓦	驀	màk
默	默	màk
万	万	màk
墨	墨	màk
脉	脈	màk
麦	麥	màk
谩	謾	màn
慢	慢	màn
漫	漫	màn
缦	縵	màn
熳	熳	màn
蔓	蔓	màn
镘	鏝	màn
嫚	嫚	màn
曼	曼	màn
万	萬	màn
幔	幔	màn
墁	墁	màn
孟	孟	màng
汶	汶	mànt
问	問	mànt
紊	紊	mànt
蜜	蜜	màt
勿	勿	màt
密	密	màt
物	物	màt
袜	襪	màt
谧	謐	màt
宓	宓	màt
嘧	嘧	màt
懋	懋	màu
貌	貌	màu
袤	袤	màu
茂	茂	màw
贸	貿	màw
谬	謬	màw
袂	袂	mày
玛	瑪	má
码	碼	má
蚂	螞	má
犸	獁	má
马	馬	má
荬	蕒	mái
买	買	mái
晚	晚	mán
猛	猛	máng
锰	錳	máng
蜢	蜢	máng
勐	勐	máng
闽	閩	mánt
闵	閔	mánt
吻	吻	mánt
刎	刎	mánt
悯	憫	mánt
鳘	鰵	mánt
黾	黽	mánt
湣	湣	mánt
愍	愍	mánt
抿	抿	mánt
泯	泯	mánt
敏	敏	mánt
渑	澠	mánt
铆	鉚	máu
卯	卯	máu
某	某	máw
牡	牡	máw
亩	畝	máw
米	米	máy
嘛	嘛	mâ
擘	擘	mâg
嬷	嬤	mä
妈	媽	mä
吗	嗎	mä/mâ
绷	繃	mäng
蚊	蚊	mänt
猫	貓	mäu
哞	哞	mäw
咪	咪	mäy/mëy
汨	汨	mèk
鼏	鼏	mèk
觅	覓	mèk
幂	冪	mèk
命	命	mèng
命	命	mènk
未	未	mèy
味	味	mèy
寐	寐	mèy
魅	魅	mèy
媚	媚	mèy
皿	皿	ménk
酩	酩	ménk
茗	茗	ménk/menk
镁	鎂	méy
美	美	méy
娓	娓	méy
尾	尾	méy
媺	媺	méy
哶	哶	më
蔑	蔑	mìd
篾	篾	mìd
蔑	衊	mìd
灭	滅	mìd
面	麵	mìn
面	面	mìn
庙	廟	mìu
妙	妙	mìu
冕	冕	mín
娩	娩	mín
腼	靦	mín
勉	勉	mín
缅	緬	mín
免	免	mín
邈	邈	míu
藐	藐	míu
淼	淼	míu
杳	杳	míu
缈	緲	míu
秒	秒	míu
渺	渺	míu
喵	喵	mïu
莫	莫	mòg
幕	幕	mòg
膜	膜	mòg
漠	漠	mòg
寞	寞	mòg
木	木	mòk
沐	沐	mòk
穆	穆	mòk
睦	睦	mòk
钼	鉬	mòk
苜	苜	mòk
仫	仫	mòk
目	目	mòk
牧	牧	mòk
望	望	mòng
梦	夢	mònk
耄	耄	mòw
慕	慕	mòw
帽	帽	mòw
雾	霧	mòw
瑁	瑁	mòw
暮	暮	mòw
冒	冒	mòw
骛	騖	mòw
婺	婺	mòw
募	募	mòw
戊	戊	mòw
务	務	mòw
墓	墓	mòw
鹜	鶩	mòw
惘	惘	móng
妄	妄	móng
辋	輞	móng
魍	魍	móng
罔	罔	móng
蟒	蟒	móng
网	網	móng
蠓	蠓	mónk
懵	懵	mónk/mõnk
拇	拇	mów
姆	姆	mów
侮	侮	mów
武	武	mów
舞	舞	mów
妩	嫵	mów
鹉	鵡	mów
母	母	mów
摸	摸	mõ
魔	魔	mö
摩	摩	mö
么	麼	mö
剥	剝	mög
没	沒	mùd
殁	歿	mùd
末	末	mùd
靺	靺	mùd
茉	茉	mùd
妹	妹	mùi
昧	昧	mùi
焖	燜	mùn
闷	悶	mùn
每	每	múi
螨	蟎	mún
满	滿	mún
沫	沫	mûd
抹	抹	mûd/mâd
拿	拿	na
南	南	na
哪	哪	na
娜	娜	na
男	男	nam
楠	楠	nam
南	南	nam
喃	喃	nam
囡	囡	nam
难	難	nan
能	能	nank
桡	橈	nau
猱	猱	nau
挠	撓	nau
锚	錨	nau
铙	鐃	nau
泥	泥	nay
呢	呢	nay/ney
狞	獰	nenk
柠	檸	nenk
宁	寧	nenk
咛	嚀	nenk
娘	娘	neong
怩	怩	ney
妮	妮	ney
尼	尼	ney
弥	彌	ney
铌	鈮	ney
嫩	嫩	neùn
暖	暖	neún
鼯	鼯	ng
蜈	蜈	ng
吾	吾	ng
梧	梧	ng
吴	吳	ng
牙	牙	nga
芽	芽	nga
衙	衙	nga
涯	涯	ngai
厓	厓	ngai
睚	睚	ngai
崖	崖	ngai
挨	捱	ngai
癌	癌	ngam
岩	岩	ngam
颜	顏	ngan
龂	齗	ngant
龈	齦	ngant
垠	垠	ngant
沂	沂	ngant
银	銀	ngant
淆	淆	ngau
爻	爻	ngau
肴	餚	ngau
牛	牛	ngaw
猊	猊	ngay
霓	霓	ngay
危	危	ngay
倪	倪	ngay
巍	巍	ngay
鹅	鵝	ngo
哦	哦	ngo
讹	訛	ngo
俄	俄	ngo
峨	峨	ngo
娥	娥	ngo
莪	莪	ngo
蛾	蛾	ngo
呆	呆	ngoi
昂	昂	ngong
鳌	鰲	ngow
獒	獒	ngow
骜	驁	ngow
敖	敖	ngow
螯	螯	ngow
翱	翱	ngow
熬	熬	ngow/ngaw
遨	遨	ngow/ngòw
讶	訝	ngà
额	額	ngàg
砹	砹	ngài
艾	艾	ngài
刈	刈	ngài
赝	贗	ngàn
雁	雁	ngàn
硬	硬	ngàng
杌	杌	ngàt
兀	兀	ngàt
圪	圪	ngàt
迄	迄	ngàt
屹	屹	ngàt
艺	藝	ngày
呓	囈	ngày
毅	毅	ngày
睨	睨	ngày
伪	偽	ngày
羿	羿	ngày
魏	魏	ngày
诣	詣	ngày
佤	佤	ngá
雅	雅	ngá
瓦	瓦	ngá
眼	眼	ngán
咬	咬	ngáu
偶	偶	ngáw
藕	藕	ngáw
蚁	蟻	ngáy
勾	勾	ngäw
啮	齧	ngìd/ngàd
卧	臥	ngò
饿	餓	ngò
愕	愕	ngòg
岳	嶽	ngòg
岳	岳	ngòg
鄂	鄂	ngòg
鳄	鱷	ngòg
噩	噩	ngòg
颚	顎	ngòg
乐	樂	ngòg
外	外	ngòi
碍	礙	ngòi
岸	岸	ngòn
犴	犴	ngòn
傲	傲	ngòw
我	我	ngó
盎	盎	ngông/ngõng
懊	懊	ngôw
澳	澳	ngôw
奥	奧	ngôw
袄	襖	ngôw/ngõw
肮	骯	ngöng/ngông
鲇	鯰	nim
年	年	nin
挪	挪	no
挼	挼	no
馕	饢	nong
瓤	瓤	nong
囔	囔	nong
囊	囊	nong
农	農	nonk
侬	儂	nonk
浓	濃	nonk
脓	膿	nonk
奴	奴	now
呐	吶	nàb
纳	納	nàb
衲	衲	nàb
钠	鈉	nàb
捺	捺	nàd
难	難	nàn
闹	鬧	nàu
淖	淖	nàu
哪	哪	ná
那	那	ná
乃	乃	nái
氖	氖	nái
奶	奶	nái
鼐	鼐	nái
腩	腩	nám
稔	稔	námp
赧	赧	nán
纽	紐	nãw
妞	妞	nãw
狃	狃	nãw
朽	朽	nãw
钮	鈕	nãw
扭	扭	nãw
哪	哪	nä
粒	粒	näp/läp
孬	孬	näu
佞	佞	nènk
拧	擰	nènk
泞	濘	nènk
腻	膩	nèy
饵	餌	nèy
你	你	néy
你	妳	néy
旎	旎	néy
您	您	néy
呢	呢	në
匿	匿	nëk
昵	暱	nëk
溺	溺	nëk/nèk
捏	捏	nìb
聂	聶	nìb
颞	顳	nìb
镊	鑷	nìb
涅	涅	nìb
陧	隉	nìb
蹑	躡	nìb
念	念	nìm
念	唸	nìm
廿	廿	nìm
尿	尿	nìu
溺	溺	nìu
碾	碾	nín
鸟	鳥	níu
袅	裊	níu
镍	鎳	nïb
拈	拈	nïm
粘	粘	nïm/jïm
黏	黏	nïm/jïm
糯	糯	nò
懦	懦	nò
诺	諾	nòg
内	內	nòi
奈	奈	nòi
耐	耐	nòi
忸	忸	nòk/nãw
齉	齉	nòng
讷	訥	nòt/nàb
怒	怒	nòw
馕	饢	nóng
脑	腦	nów
恼	惱	nów
瑙	瑙	nów
弩	弩	nów
努	努	nów/lów
钕	釹	nóy
馁	餒	nóy
女	女	nóy/lóy
捻	捻	nĩm
哦	哦	o
琶	琶	pa
爬	爬	pa
耙	耙	pa
杷	杷	pa
扒	扒	pa
俳	俳	pai
排	排	pai
牌	牌	pai
硼	硼	pang
澎	澎	pang
棚	棚	pang
鹏	鵬	pang
膨	膨	pang
彭	彭	pang
朋	朋	pank
凭	憑	pank
贫	貧	pant
嫔	嬪	pant
频	頻	pant
颦	顰	pant
匏	匏	pau
咆	咆	pau
狍	麅	pau
刨	刨	pau
庖	庖	pau
抔	抔	paw
评	評	penk
萍	萍	penk
平	平	penk
屏	屏	penk
坪	坪	penk
苹	蘋	penk
瓶	瓶	penk
郫	郫	pey
枇	枇	pey
蜱	蜱	pey
脾	脾	pey
貔	貔	pey
琵	琵	pey
毗	毗	pey
皮	皮	pey
邳	邳	pey
疲	疲	pey
骈	駢	pin
便	便	pin
瓢	瓢	piu
嫖	嫖	piu
朴	朴	piu
婆	婆	po
鄱	鄱	po/bô
膀	膀	pong
彷	彷	pong
庞	龐	pong
螃	螃	pong
滂	滂	pong
磅	磅	pong
旁	旁	pong
篷	篷	ponk
芃	芃	ponk
蓬	蓬	ponk/fonk
莆	莆	pow
蒲	蒲	pow
葡	葡	pow
脯	脯	pow
匍	匍	pow
袍	袍	pow
菩	菩	pow
徘	徘	pui
陪	陪	pui
裴	裴	pui
培	培	pui
赔	賠	pui
蟠	蟠	pun
盘	盤	pun
磐	磐	pun
槃	槃	pun
盆	盆	pun
蹒	蹣	pun/mun
棒	棒	páng
牝	牝	pánt
睥	睥	páy
怕	怕	pâ
柏	柏	pâg
拍	拍	pâg
珀	珀	pâg
帕	帕	pâg
魄	魄	pâg
哌	哌	pâi
派	派	pâi
湃	湃	pâi/bâi
盼	盼	pân
袢	袢	pân
喷	噴	pânt
炮	炮	pâu
豹	豹	pâu
泡	泡	pâu
疱	疱	pâu
跑	跑	pãu
剖	剖	pãw
趴	趴	pä
啪	啪	päg
攀	攀	pän
扳	扳	pän
烹	烹	päng
澎	澎	päng
匹	匹	pät
疋	疋	pät
泡	泡	päu
抛	拋	päu
脬	脬	päu
批	批	päy
被	被	péy
婢	婢	péy
劈	劈	pêg
聘	聘	pênk
譬	譬	pêy
屁	屁	pêy
濞	濞	pêy
媲	媲	pêy/bẽy
癖	癖	pëk
辟	辟	pëk
僻	僻	pëk
霹	霹	pëk
辟	闢	pëk
抨	抨	pënk
砰	砰	pënk
怦	怦	pënk
姘	姘	pënk
娉	娉	pënk
拼	拼	pënk/pênk
纰	紕	pëy
呸	呸	pëy
狉	狉	pëy
披	披	pëy
丕	丕	pëy
鳔	鰾	píu
瞟	瞟	píu
瞥	瞥	pîd
撇	撇	pîd
骗	騙	pîn
片	片	pîn
遍	遍	pîn
漂	漂	pîu
票	票	pîu
剽	剽	pîu/píu
编	編	pïn
偏	偏	pïn
翩	翩	pïn
扁	扁	pïn
篇	篇	pïn
蝙	蝙	pïn/bïn
漂	漂	pïu
飘	飄	pïu
嘌	嘌	pïu
缥	縹	pïu
蚌	蚌	póng
抱	抱	pów
泡	泡	pów
破	破	pô
扑	撲	pôg
噗	噗	pôg
朴	樸	pôg
钋	釙	pôg
璞	璞	pôg
粕	粕	pôg/pâg
谤	謗	pông
碰	碰	pônk
铺	舖	pôw
叵	叵	põ
颇	頗	põ
笸	笸	põ
捧	捧	põnk/bõnk
浦	浦	põw
谱	譜	põw
普	普	põw
溥	溥	põw
脯	脯	põw/fũ
颇	頗	pö
坡	坡	pö/bö
棵	棵	pö/fõ
仆	仆	pök
铺	鋪	pöw
倍	倍	púi
蓓	蓓	púi/pui
泼	潑	pûd
霈	霈	pûi
佩	佩	pûi
珮	珮	pûi
沛	沛	pûi
配	配	pûi
拚	拚	pûn
判	判	pûn
胚	胚	püi
坯	坯	püi
番	番	pün
潘	潘	pün
片	片	pĩn
片	片	pĩn
仳	仳	pẽy
痞	痞	pẽy
吡	吡	pẽy
否	否	pẽy
圮	圮	pẽy
鄙	鄙	pẽy
忱	忱	samp
涔	涔	samp
岑	岑	samp
梣	梣	samp
潺	潺	san
孱	孱	san
晨	晨	sant
臣	臣	sant
辰	辰	sant
神	神	sant
仇	仇	saw
愁	愁	saw
蛇	蛇	se
畲	畲	se
城	城	senk
成	成	senk
乘	乘	senk
盛	盛	senk
丞	丞	senk
诚	誠	senk
绳	繩	senk
渑	澠	senk
承	承	senk
偿	償	seong
裳	裳	seong
徜	徜	seong
尝	嘗	seong
尝	嚐	seong
常	常	seong
嫦	嫦	seong
殊	殊	seu
薯	薯	seu
漩	漩	seun
璇	璇	seun
旋	旋	seun
船	船	seun
上	上	seòng
尚	尚	seòng
上	上	seóng
烁	爍	seôg
铄	鑠	seôg
削	削	seôg
相	相	seông
鲞	鯗	seõng
想	想	seõng
赏	賞	seõng
伤	傷	seöng
厢	廂	seöng
霜	霜	seöng
双	雙	seöng
商	商	seöng
孀	孀	seöng
鹴	鸘	seöng
相	相	seöng
襄	襄	seöng
箱	箱	seöng
湘	湘	seöng
觞	觴	seöng
殇	殤	seöng
镶	鑲	seöng
竖	豎	seù
树	樹	seù
篆	篆	seùn
隽	雋	seún
吮	吮	seún
戍	戍	seû
恕	恕	seû
庶	庶	seû
雪	雪	seûd
鳕	鱈	seûd
说	說	seûd
算	算	seûn
蒜	蒜	seûn
渲	渲	seûn/heün
舒	舒	seü
抒	抒	seü
书	書	seü
输	輸	seü
纾	紓	seü
枢	樞	seü
悛	悛	seün
瑄	瑄	seün
飧	飧	seün
狻	狻	seün
荪	蓀	seün
宣	宣	seün
酸	酸	seün
狲	猻	seün
孙	孫	seün
黍	黍	seũ
暑	暑	seũ
鼠	鼠	seũ
损	損	seũn
选	選	seũn
莳	蒔	si
匙	匙	si
鲥	鰣	si
时	時	si
蟾	蟾	sim
禅	禪	sim
单	單	sim
蝉	蟬	sin
傻	傻	so
崇	崇	sonk
淳	淳	sont
唇	脣	sont
醇	醇	sont
纯	純	sont
鹑	鶉	sont/cönt
谁	誰	soy
垂	垂	soy
什	什	sàmp
甚	甚	sàmp
葚	椹	sàmp
慎	慎	sànt
蜃	蜃	sànt/sánt
拾	拾	sàp
十	十	sàp
实	實	sàt
寿	壽	sàw
授	授	sàw
受	受	sàw
售	售	sàw
绶	綬	sàw
噬	噬	sày
誓	誓	sày
筮	筮	sày
逝	逝	sày
肾	腎	sánt
舐	舐	sáy/sãy
圾	圾	sâb
飒	颯	sâb
萨	薩	sâd
铩	鎩	sâd
煞	煞	sâd
杀	殺	sâd
撒	撒	sâd
刹	剎	sâd
索	索	sâg/sôg
晒	曬	sâi
三	三	sâm
沁	沁	sâmp
渗	滲	sâmp
讪	訕	sân
汕	汕	sân
涮	涮	sân
伞	傘	sân
散	散	sân
疝	疝	sân
篡	篡	sân
蹭	蹭	sânk
擤	擤	sânk
霎	霎	sâp
哨	哨	sâu
狩	狩	sâw
嗽	嗽	sâw
兽	獸	sâw
锈	鏽	sâw
绣	繡	sâw
漱	漱	sâw
琇	琇	sâw
秀	秀	sâw
瘦	瘦	sâw
宿	宿	sâw
世	世	sây
细	細	sây
势	勢	sây
婿	婿	sây
耍	耍	sã
洒	灑	sã
玺	璽	sãi
徙	徙	sãi
婶	嬸	sãmp
审	審	sãmp
沈	瀋	sãmp
沈	沈	sãmp
散	散	sãn
省	省	sãng
稍	稍	sãu
首	首	sãw
搜	搜	sãw
守	守	sãw
手	手	sãw
嗾	嗾	sãw
擞	擻	sãw
艘	艘	sãw/säw
驶	駛	sãy
使	使	sãy
洗	洗	sãy
莎	莎	sä
纱	紗	sä
鲨	鯊	sä
卅	卅	sä
砂	砂	sä
裟	裟	sä
啥	啥	sä
痧	痧	sä
沙	沙	sä
噻	噻	säk
塞	塞	säk
三	三	säm
仨	仨	säm
叁	叄	säm
衫	衫	säm
心	心	sämp
参	參	sämp
郴	郴	sämp
深	深	sämp
琛	琛	sämp
芯	芯	sämp
森	森	sämp
删	刪	sän
潸	潸	sän
舢	舢	sän
拴	拴	sän
姗	姍	sän
山	山	sän
闩	閂	sän
珊	珊	sän
栓	栓	sän
跚	跚	sän
甥	甥	säng
牲	牲	säng
笙	笙	sänk
生	生	sänk/säng
燊	燊	sänt
呻	呻	sänt
伸	伸	sänt
新	新	sänt
薪	薪	sänt
娠	娠	sänt
身	身	sänt
砷	砷	sänt
辛	辛	sänt
锌	鋅	sänt
莘	莘	sänt
绅	紳	sänt
申	申	sänt
湿	濕	säp
涩	澀	säp/sëk/gîb
室	室	sät
虱	蝨	sät
失	失	sät
膝	膝	sät
瑟	瑟	sät
捎	捎	säu
梢	梢	säu
收	收	säw
螋	螋	säw
嗖	嗖	säw
馊	餿	säw
飕	颼	säw
羞	羞	säw
修	修	säw
搜	搜	säw/sãw
筛	篩	säy
犀	犀	säy
嘶	嘶	säy
西	西	säy
舾	舾	säy
硒	硒	säy
射	射	sè
麝	麝	sè
硕	碩	sèg
石	石	sèg
蚀	蝕	sèk
食	食	sèk
盛	盛	sènk
剩	剩	sènk
嵊	嵊	sènk
社	社	sé
猞	猞	sê
卸	卸	sê
赦	赦	sê
泻	瀉	sê
舍	舍	sê
锡	錫	sêg
姓	姓	sênk
胜	勝	sênk
圣	聖	sênk
性	性	sênk
四	四	sêy
些	些	së
昔	昔	sëk
铯	銫	sëk
饰	飾	sëk
晰	晰	sëk
析	析	sëk
识	識	sëk
蜥	蜥	sëk
拭	拭	sëk
息	息	sëk
皙	皙	sëk
惜	惜	sëk
色	色	sëk
适	適	sëk
媳	媳	sëk
啬	嗇	sëk
轼	軾	sëk
淅	淅	sëk
式	式	sëk
蟋	蟋	sëk
悉	悉	sëk
螫	螫	sëk
熄	熄	sëk
释	釋	sëk
升	陞	sënk
惺	惺	sënk
猩	猩	sënk
星	星	sënk
升	升	sënk
升	昇	sënk
胜	勝	sënk
腥	腥	sënk/sëng
声	聲	sënk/sëng
侍	侍	sì
士	士	sì
事	事	sì
是	是	sì
伺	伺	sì
仕	仕	sì
豉	豉	sì
氏	氏	sì
视	視	sì
示	示	sì
赡	贍	sìm
膳	膳	sìn
掸	撣	sìn
嬗	嬗	sìn
擅	擅	sìn
缮	繕	sìn
倩	倩	sìn
善	善	sìn
羡	羨	sìn
禅	禪	sìn
单	單	sìn
鄯	鄯	sìn
茜	茜	sìn/säy
邵	邵	sìu
劭	劭	sìu
肇	肇	sìu
兆	兆	sìu
绍	紹	sìu
市	市	sí
鳝	鱔	sín
泗	泗	sî
使	使	sî
嗜	嗜	sî
弑	弒	sî
肆	肆	sî
谥	諡	sî
试	試	sî
驷	駟	sî
摄	攝	sîb
歙	歙	sîb
涉	涉	sîb
慑	懾	sîb/jîb
舌	舌	sîd
亵	褻	sîd
窃	竊	sîd
泄	洩	sîd
薛	薛	sîd
屑	屑	sîd
楔	楔	sîd
绁	絏	sîd
揳	揳	sîd/sîb
腺	腺	sîn
扇	扇	sîn
煽	煽	sîn
骟	騸	sîn
霰	霰	sîn
线	線	sîn
啸	嘯	sîu
笑	笑	sîu
少	少	sîu
尸	尸	sï
丝	絲	sï
师	師	sï
狮	獅	sï
诗	詩	sï
私	私	sï
撕	撕	sï
蓍	蓍	sï
斯	斯	sï
司	司	sï
施	施	sï
尸	屍	sï
厮	廝	sï
思	思	sï
仙	仙	sïn
鲜	鮮	sïn
酰	酰	sïn
先	先	sïn
氙	氙	sïn/sän
消	消	sïu
销	銷	sïu
烧	燒	sïu
霄	霄	sïu
宵	宵	sïu
萧	蕭	sïu
硝	硝	sïu
逍	逍	sïu
箫	簫	sïu
韶	韶	sïu
潇	瀟	sïu
魈	魈	sïu
孰	孰	sòk
属	屬	sòk
淑	淑	sòk
塾	塾	sòk
蜀	蜀	sòk
菽	菽	sòk
熟	熟	sòk
赎	贖	sòk
顺	順	sònt
沭	沭	sòt
述	述	sòt
术	術	sòt
萃	萃	sòy
燧	燧	sòy
邃	邃	sòy
隧	隧	sòy
瑞	瑞	sòy
穗	穗	sòy
祟	祟	sòy
粹	粹	sòy
遂	遂	sòy
悴	悴	sòy
睡	睡	sòy
瘁	瘁	sòy/sóy
绪	緒	sóy
髓	髓	sóy
墅	墅	sóy
絮	絮	sóy/sòy
索	索	sôg
说	說	sôg
朔	朔	sôg
丧	喪	sông
送	送	sônk
宋	宋	sônk
巽	巽	sônt
舜	舜	sônt
信	信	sônt
迅	迅	sônt
浚	浚	sônt
瞬	瞬	sônt
逊	遜	sônt
讯	訊	sônt
汛	汛	sônt
囟	囟	sônt/sõnt
诉	訴	sôw
数	數	sôw
溯	溯	sôw
扫	掃	sôw
塑	塑	sôw
愫	愫	sôw
臊	臊	sôw
素	素	sôw
帅	帥	sôy
岁	歲	sôy
碎	碎	sôy
税	稅	sôy
说	說	sôy
琐	瑣	sõ
锁	鎖	sõ
唢	嗩	sõ
所	所	sõ
嗓	嗓	sõng
搡	搡	sõng
爽	爽	sõng
竦	竦	sõnk
怂	慫	sõnk
耸	聳	sõnk
悚	悚	sõnk
榫	榫	sõnt
笋	筍	sõnt
数	數	sõw
嫂	嫂	sõw
水	水	sõy
梭	梭	sö
唆	唆	sö
梳	梳	sö
羧	羧	sö
嗦	嗦	sö
疏	疏	sö
蔬	蔬	sö
蓑	蓑	sö
腮	腮	söi
鳃	鰓	söi
夙	夙	sök
粟	粟	sök
宿	宿	sök
蓿	蓿	sök
鹔	鷫	sök
叔	叔	sök
肃	肅	sök
倏	倏	sök
缩	縮	sök
僳	僳	sök
桑	桑	söng
丧	喪	söng
嵩	嵩	sönk
从	從	sönk
淞	淞	sönk
松	鬆	sönk
忪	忪	sönk
荀	荀	sönt
芯	芯	sönt
询	詢	sönt
殉	殉	sönt
峋	峋	sönt
恤	恤	söt
摔	摔	söt
蟀	蟀	söt
率	率	söt
戌	戌	söt
骚	騷	söw
苏	囌	söw
苏	蘇	söw
搔	搔	söw
甦	甦	söw
酥	酥	söw
须	鬚	söw
臊	臊	söw
稣	穌	söw
虽	雖	söy
荽	荽	söy
须	須	söy
胥	胥	söy
需	需	söy
衰	衰	söy
睢	睢	söy
濉	濉	söy
绥	綏	söy
屎	屎	sĩ
使	使	sĩ
史	史	sĩ
陕	陝	sĩm
闪	閃	sĩm
跣	跣	sĩn
鲜	鮮	sĩn
冼	冼	sĩn
癣	癬	sĩn
少	少	sĩu
筱	筱	sĩu
小	小	sĩu
舍	捨	sẽ
写	寫	sẽ
省	省	sẽnk
醒	醒	sẽnk/sẽng
死	死	sẽy
覃	覃	tam
澹	澹	tam
谈	談	tam
昙	曇	tam
郯	郯	tam
谭	譚	tam
潭	潭	tam
痰	痰	tam
弹	彈	tan
檀	檀	tan
坛	壇	tan
誊	謄	tank
疼	疼	tank
腾	騰	tank
藤	藤	tank
滕	滕	tank
头	頭	taw
投	投	taw
骰	骰	taw/sëk
堤	堤	tay
缇	緹	tay
醍	醍	tay
啼	啼	tay
鹈	鵜	tay
蹄	蹄	tay
题	題	tay
提	提	tay
廷	廷	tenk
亭	亭	tenk
庭	庭	tenk
婷	婷	tenk
霆	霆	tenk
蜓	蜓	tenk
停	停	tenk
臀	臀	teun
团	糰	teun
屯	屯	teun
豚	豚	teun
团	團	teun
囤	囤	teun
断	斷	teún
脱	脫	teûd
恬	恬	tim
甜	甜	tim
阗	闐	tin
钿	鈿	tin
田	田	tin
填	填	tin
钿	鈿	tin/dìn
滇	滇	tin/dïn
迢	迢	tiu
笤	笤	tiu
龆	齠	tiu
条	條	tiu
调	調	tiu
髫	髫	tiu
舵	舵	to
驮	馱	to
佗	佗	to
鸵	鴕	to
驼	駝	to
沱	沱	to
陀	陀	to
台	颱	toi
跆	跆	toi
台	台	toi
苔	苔	toi
台	枱	toi
薹	薹	toi
抬	抬	toi
醣	醣	tong
幢	幢	tong
塘	塘	tong
膛	膛	tong
唐	唐	tong
棠	棠	tong
堂	堂	tong
溏	溏	tong
螳	螳	tong
搪	搪	tong/tóng
糖	糖	tong/tõng
同	衕	tonk
彤	彤	tonk
峒	峒	tonk
同	同	tonk
僮	僮	tonk
桐	桐	tonk
瞳	瞳	tonk
佟	佟	tonk
铜	銅	tonk
酮	酮	tonk
童	童	tonk
潼	潼	tonk
陶	陶	tow
屠	屠	tow
梼	檮	tow
啕	啕	tow
洮	洮	tow
涂	涂	tow
图	圖	tow
逃	逃	tow
涂	塗	tow
萄	萄	tow
鼗	鼗	tow
掏	掏	tow
桃	桃	tow
徒	徒	tow
淘	淘	tow
荼	荼	tow
途	途	tow
涛	濤	tow
颓	頹	toy
淡	淡	tám
榻	榻	tâb
塌	塌	tâb
塔	塔	tâb
漯	漯	tâb
遢	遢	tâb/tâd
闼	闥	tâd
挞	撻	tâd
跶	躂	tâd
鞑	韃	tâd
趿	趿	tâd
肽	肽	tâi
太	太	tâi
贷	貸	tâi
汰	汰	tâi
泰	泰	tâi
傣	傣	tâi
态	態	tâi
钛	鈦	tâi
探	探	tâm
坛	罈	tâm
炭	炭	tân
叹	歎	tân
碳	碳	tân
褪	褪	tânt
透	透	tâw
嚏	嚏	tây
替	替	tây
屉	屜	tây
涕	涕	tây
剃	剃	tây
毯	毯	tãm
袒	袒	tãn
钽	鉭	tãn
忐	忐	tãn
疸	疸	tãn
亶	亶	tãn
坦	坦	tãn
体	體	tãy
它	牠	tä
铊	鉈	tä
他	祂	tä
她	她	tä
它	它	tä
他	他	tä
贪	貪	täm
瘫	癱	tän
摊	攤	tän
坍	坍	tän
滩	灘	tän
吞	吞	tänt
饨	飩	tänt
偷	偷	täw
梯	梯	täy
锑	銻	täy
挺	挺	ténk
铤	鋌	ténk
艇	艇	ténk/téng
踢	踢	têg
听	聽	tênk
忑	忑	tëk
倜	倜	tëk
剔	剔	tëk
惕	惕	tëk
忒	忒	tëk
铽	鋱	tëk
汀	汀	tënk
烃	烴	tënk
厅	廳	tënk/tëng
听	聽	tënk/tëng
殄	殄	tín/tím
窕	窕	tíu
挑	挑	tíu
萜	萜	tîb
贴	貼	tîb
帖	帖	tîb
餮	餮	tîd
铁	鐵	tîd
跳	跳	tîu
眺	眺	tîu
添	添	tïm
天	天	tïn
挑	挑	tïu
盾	盾	tónt
肚	肚	tów
唾	唾	tô/teô
橐	橐	tôg
拓	拓	tôg
庹	庹	tôg
托	托	tôg
托	託	tôg
蹚	蹚	tông
熨	熨	tông
趟	趟	tông
烫	燙	tông
痛	痛	tônk
彖	彖	tônt
套	套	tôw
兔	兔	tôw
吐	吐	tôw
退	退	tôy
蜕	蛻	tôy
椭	橢	tõ
妥	妥	tõ
倘	倘	tõng
淌	淌	tõng
傥	儻	tõng
帑	帑	tõng
躺	躺	tõng
捅	捅	tõnk
桶	桶	tõnk
统	統	tõnk
筒	筒	tõnk/tonk
讨	討	tõw
钍	釷	tõw
祷	禱	tõw
土	土	tõw
腿	腿	tõy
拖	拖	tö
苔	苔	töi
胎	胎	töi
秃	禿	tök
汤	湯	töng
通	通	tönk
湍	湍	tönt/jeün
饕	饕	töw
叨	叨	töw
韬	韜	töw
滔	滔	töw
推	推	töy
舔	舔	tĩm
腆	腆	tĩn
华	華	wa
骅	驊	wa
划	划	wa/wä
槐	槐	wai
淮	淮	wai
怀	懷	wai
鬟	鬟	wan
玩	玩	wan
寰	寰	wan
还	還	wan
环	環	wan
顽	頑	wan
横	橫	wang
弘	弘	wank
宏	宏	wank
闳	閎	wank
鋆	鋆	want
匀	勻	want
浑	渾	want
魂	魂	want
馄	餛	want
云	云	want
妘	妘	want
芸	芸	want
纭	紜	want
芸	蕓	want
昀	昀	want
珲	琿	want
筠	筠	want
晕	暈	want
耘	耘	want
云	雲	want
违	違	way
维	維	way
围	圍	way
惟	惟	way
为	為	way
帷	帷	way
唯	唯	way
闱	闈	way
潍	濰	way
桅	桅	way
遗	遺	way
嵘	嶸	wenk
荣	榮	wenk
禾	禾	wo
和	和	wo
隍	隍	wong
徨	徨	wong
簧	簧	wong
王	王	wong
凰	凰	wong
煌	煌	wong
潢	潢	wong
遑	遑	wong
黄	黃	wong
惶	惶	wong
磺	磺	wong
皇	皇	wong
蟥	蟥	wong
蝗	蝗	wong
鹕	鶘	wu
胡	衚	wu
胡	鬍	wu
糊	餬	wu
煳	煳	wu
猢	猢	wu
瑚	瑚	wu
蝴	蝴	wu
狐	狐	wu
湖	湖	wu
弧	弧	wu
胡	胡	wu
壶	壺	wu
糊	糊	wu
葫	葫	wu
醐	醐	wu
洄	洄	wui
徊	徊	wui
回	迴	wui
回	回	wui
蛔	蛔	wui
桓	桓	wun
垣	垣	wun
援	援	wun/yeun
华	華	wà
话	話	wà
桦	樺	wà/wa
滑	滑	wàd
猾	猾	wàd
惑	惑	wàg
画	畫	wàg
划	劃	wàg
或	或	wàg
坏	壞	wài
患	患	wàn
幻	幻	wàn
宦	宦	wàn
横	橫	wàng
郓	鄆	wànt
诨	諢	wànt
运	運	wànt
晕	暈	wànt
混	混	wànt
熨	熨	wànt
韵	韻	wànt/wánt
鹬	鷸	wàt
聿	聿	wàt/lòt
渭	渭	wày
位	位	wày
惠	惠	wày
谓	謂	wày
卫	衛	wày
胃	胃	wày
为	為	wày
蕙	蕙	wày
彗	彗	wày
猬	蝟	wày
慧	慧	wày
踝	踝	wá
挽	輓	wán
挽	挽	wán
允	允	wánt
殒	殞	wánt
尹	尹	wánt
陨	隕	wánt
狁	狁	wánt
玮	瑋	wáy
韪	韙	wáy
讳	諱	wáy
苇	葦	wáy
纬	緯	wáy
伟	偉	wáy
韦	韋	wáy
挖	挖	wâd
斡	斡	wâd
蕴	蘊	wânt
愠	慍	wânt
酝	醞	wânt
揾	搵	wânt
喂	喂	wây
畏	畏	wây
尉	尉	wây
慰	慰	wây
蔚	蔚	wây
喂	餵	wây
秽	穢	wây
荟	薈	wây/wùi
话	話	wã
剐	剮	wã
画	畫	wã/wà
绾	綰	wãn
玩	玩	wãn
稳	穩	wãnt
萎	萎	wãy
喟	喟	wãy
痿	痿	wãy
卉	卉	wãy
猥	猥	wãy
委	委	wãy
毁	毀	wãy
哗	譁	wä
娃	娃	wä
哇	哇	wä
蛙	蛙	wä
凹	凹	wä
哗	嘩	wä
洼	窪	wä
歪	歪	wäi
弯	彎	wän
湾	灣	wän
氲	氳	wänt
温	溫	wänt
瘟	瘟	wänt
屈	屈	wät
郁	鬱	wät
委	委	wäy
威	威	wäy
逶	逶	wäy
崴	崴	wäy
葳	葳	wäy
蜮	蜮	wèk
阈	閾	wèk
域	域	wèk
咏	詠	wènk
泳	泳	wènk
颖	穎	wènk
颍	潁	wènk
永	永	wénk
扔	扔	wënk
祸	禍	wò
镬	鑊	wòg
获	穫	wòg
获	獲	wòg
旺	旺	wòng
往	往	wóng
枉	枉	wõng
窝	窩	wö
倭	倭	wö
锅	鍋	wö
挝	撾	wö
娲	媧	wö
莴	萵	wö
涡	渦	wö
蜗	蝸	wö
窠	窠	wö/fö
汪	汪	wöng
怙	怙	wù
祜	祜	wù
户	戶	wù
芋	芋	wù
扈	扈	wù
互	互	wù
护	護	wù
沪	滬	wù
瓠	瓠	wù/wu
活	活	wùd
烩	燴	wùi
会	會	wùi
汇	匯	wùi
汇	彙	wùi/wày
会	會	wùi/wũi
缓	緩	wùn
唤	喚	wùn
奂	奐	wùn
痪	瘓	wùn
玩	玩	wùn
焕	煥	wùn
换	換	wùn
会	會	wúi
皖	皖	wún
浣	浣	wún
恶	惡	wû
污	污	wü
恶	惡	wü
呜	嗚	wü
邬	鄔	wü
乌	烏	wü
钨	鎢	wü
偎	偎	wüi
剜	剜	wün
浒	滸	wũ
坞	塢	wũ
腕	腕	wũn
碗	碗	wũn
莞	莞	wũn
玩	玩	wũn/wùn
豌	豌	wũn/wün
惋	惋	wũn/yeũn
霪	霪	yamp
壬	壬	yamp
任	任	yamp
吟	吟	yamp
淫	淫	yamp
仁	仁	yant
夤	夤	yant
寅	寅	yant
人	人	yant
犹	猶	yaw
游	游	yaw
蹂	蹂	yaw
铀	鈾	yaw
游	遊	yaw
酋	酋	yaw
蚰	蚰	yaw
尤	尤	yaw
攸	攸	yaw
由	由	yaw
悠	悠	yaw
揉	揉	yaw
油	油	yaw
疣	疣	yaw
邮	郵	yaw
鱿	魷	yaw
柔	柔	yaw
椰	椰	ye
邪	邪	ye
爷	爺	ye
揶	揶	ye
耶	耶	ye
赢	贏	yeng
荥	滎	yenk
盈	盈	yenk
莹	瑩	yenk
凝	凝	yenk
型	型	yenk
荧	熒	yenk
陉	陘	yenk
迎	迎	yenk
蓥	鎣	yenk
嬴	嬴	yenk
楹	楹	yenk
赢	贏	yenk
邢	邢	yenk
萦	縈	yenk
瀛	瀛	yenk
仍	仍	yenk
营	營	yenk
潆	瀠	yenk
形	形	yenk
刑	刑	yenk
蝇	蠅	yenk
萤	螢	yenk
滢	瀅	yenk/yènk
徉	徉	yeong
阳	陽	yeong
羊	羊	yeong
飏	颺	yeong
疡	瘍	yeong
烊	烊	yeong
杨	楊	yeong
扬	揚	yeong
瀼	瀼	yeong
禳	禳	yeong
穰	穰	yeong
蘘	蘘	yeong
洋	洋	yeong
旸	暘	yeong
佯	佯	yeong
萸	萸	yeu
揄	揄	yeu
逾	逾	yeu
臾	臾	yeu
虞	虞	yeu
俞	俞	yeu
如	如	yeu
隅	隅	yeu
竽	竽	yeu
濡	濡	yeu
愚	愚	yeu
妤	妤	yeu
愉	愉	yeu
瑜	瑜	yeu
逾	踰	yeu
予	予	yeu
禺	禺	yeu
儒	儒	yeu
榆	榆	yeu
蝓	蝓	yeu
于	于	yeu
蠕	蠕	yeu
余	余	yeu
欤	歟	yeu
鱼	魚	yeu
盂	盂	yeu
渔	漁	yeu
娱	娛	yeu
嚅	嚅	yeu
狳	狳	yeu
茹	茹	yeu
谀	諛	yeu
觎	覦	yeu
渝	渝	yeu
舆	輿	yeu
余	餘	yeu
孺	孺	yeu/yeù
元	元	yeun
袁	袁	yeun
辕	轅	yeun
圆	圓	yeun
猿	猿	yeun
眩	眩	yeun
缘	緣	yeun
烷	烷	yeun
悬	懸	yeun
原	原	yeun
沿	沿	yeun
员	員	yeun
铅	鉛	yeun
玄	玄	yeun
纨	紈	yeun
芫	芫	yeun
完	完	yeun
园	園	yeun
源	源	yeun
沅	沅	yeun
丸	丸	yeun/yeũn
疟	瘧	yeòg
龠	龠	yeòg
钥	鑰	yeòg
蒻	蒻	yeòg
弱	弱	yeòg
跃	躍	yeòg
谑	謔	yeòg
虐	虐	yeòg
若	若	yeòg
药	藥	yeòg
籥	籥	yeòg
恙	恙	yeòng
让	讓	yeòng
样	樣	yeòng
漾	漾	yeòng
酿	釀	yeòng
壤	壤	yeòng
氧	氧	yeóng
痒	癢	yeóng
仰	仰	yeóng
养	養	yeóng
攘	攘	yeóng
嚷	嚷	yeóng/yeòng
约	約	yeôg
鞅	鞅	yeõng
殃	殃	yeöng
央	央	yeöng
鸯	鴦	yeöng
秧	秧	yeöng
愈	癒	yeù
蓣	蕷	yeù
誉	譽	yeù
预	預	yeù
遇	遇	yeù
驭	馭	yeù
愈	愈	yeù
御	御	yeù
裕	裕	yeù
寓	寓	yeù
豫	豫	yeù
与	與	yeù
语	語	yeù
吁	籲	yeù
御	禦	yeù
喻	喻	yeù
谕	諭	yeù
钺	鉞	yeùd
钇	釔	yeùd
越	越	yeùd
穴	穴	yeùd
阅	閱	yeùd
曰	曰	yeùd
月	月	yeùd
悦	悅	yeùd
粤	粵	yeùd
乙	乙	yeùd/yeûd
县	縣	yeùn
愿	願	yeùn
媛	媛	yeùn
院	院	yeùn
炫	炫	yeùn/yeun
远	遠	yeùn/yeún
龉	齬	yeú
瑀	瑀	yeú
圄	圄	yeú
汝	汝	yeú
雨	雨	yeú
禹	禹	yeú
羽	羽	yeú
宇	宇	yeú
与	與	yeú
乳	乳	yeú
貐	貐	yeú
敔	敔	yeú
语	語	yeú
予	予	yeú
远	遠	yeún
阮	阮	yeún
软	軟	yeún
酗	酗	yeû/hõy/hôy
怨	怨	yeûn
淤	淤	yeü
于	於	yeü
迂	迂	yeü
冤	冤	yeün
蜿	蜿	yeün
鸢	鳶	yeün
渊	淵	yeün
鸳	鴛	yeün
妪	嫗	yeũ
伛	傴	yeũ
瘀	瘀	yeũ
菀	菀	yeũn
婉	婉	yeũn
苑	苑	yeũn
宛	宛	yeũn
琬	琬	yeũn
移	移	yi
胰	胰	yi
痍	痍	yi
儿	兒	yi
贻	貽	yi
疑	疑	yi
诒	詒	yi
怡	怡	yi
而	而	yi
谊	誼	yi
颐	頤	yi
饴	飴	yi
迤	迤	yi
仪	儀	yi
夷	夷	yi
宜	宜	yi
咦	咦	yi
彝	彞	yi
沂	沂	yi
眙	眙	yi
蛇	蛇	yi
姨	姨	yi
阎	閻	yim
嫌	嫌	yim
蚺	蚺	yim
髯	髯	yim
严	嚴	yim
炎	炎	yim
闫	閆	yim
盐	鹽	yim
檐	簷	yim/sim
舷	舷	yin
然	然	yin
贤	賢	yin
研	研	yin
涎	涎	yin
言	言	yin
弦	弦	yin
延	延	yin
燃	燃	yin
筵	筵	yin
妍	妍	yin
蜒	蜒	yin
焉	焉	yin
徭	徭	yiu
摇	搖	yiu
姚	姚	yiu
谣	謠	yiu
鳐	鰩	yiu
饶	饒	yiu
飖	颻	yiu
娆	嬈	yiu
洮	洮	yiu
遥	遙	yiu
窑	窯	yiu
尧	堯	yiu
瑶	瑤	yiu
佣	傭	yonk
榕	榕	yonk
茸	茸	yonk
蓉	蓉	yonk
镛	鏞	yonk
熔	熔	yonk
庸	庸	yonk
融	融	yonk
溶	溶	yonk
慵	慵	yonk
容	容	yonk
鳙	鱅	yonk
戎	戎	yonk
绒	絨	yonk/yõnk
蕤	蕤	yoy
饪	飪	yàmp
妊	妊	yàmp
任	任	yàmp
衽	衽	yàmp
赁	賃	yàmp
任	任	yàmp
胤	胤	yànt
孕	孕	yànt
衅	釁	yànt
刃	刃	yànt
纫	紉	yànt
韧	韌	yànt/ngànk
入	入	yàp
溢	溢	yàt
日	日	yàt
轶	軼	yàt
逸	逸	yàt
右	右	yàw
釉	釉	yàw
鼬	鼬	yàw
狖	狖	yàw
佑	佑	yàw
侑	侑	yàw
宥	宥	yàw
囿	囿	yàw
又	又	yàw
曳	曳	yày
跩	跩	yày
也	也	yá
荏	荏	yámp/yàmp
蚓	蚓	yánt
引	引	yánt
友	友	yáw
有	有	yáw
诱	誘	yáw
酉	酉	yáw
荫	蔭	yâmp
窨	窨	yâmp
印	印	yânt
幼	幼	yâw
饮	飲	yãmp
隐	隱	yãnt
忍	忍	yãnt
瘾	癮	yãnt
柚	柚	yãw
黝	黝	yãw
钦	欽	yämp
歆	歆	yämp
鑫	鑫	yämp
阴	陰	yämp
音	音	yämp
茵	茵	yänt
恩	恩	yänt
氤	氤	yänt
因	因	yänt
堙	堙	yänt
姻	姻	yänt
甄	甄	yänt
昕	昕	yänt
殷	殷	yänt
忻	忻	yänt
欣	欣	yänt
悒	悒	yäp
揖	揖	yäp
邑	邑	yäp
挹	挹	yäp
翕	翕	yäp
熠	熠	yäp
泣	泣	yäp
壹	壹	yät
一	一	yät
鸺	鵂	yäw
优	優	yäw
蚯	蚯	yäw
貅	貅	yäw
髹	髹	yäw
邱	邱	yäw
忧	憂	yäw
幽	幽	yäw
休	休	yäw
丘	丘	yäw
咻	咻	yäw
夜	夜	yè
偌	偌	yè
腋	腋	yèk
驿	驛	yèk
奕	奕	yèk
翼	翼	yèk
翊	翊	yèk
弈	弈	yèk
亦	亦	yèk
蜴	蜴	yèk
役	役	yèk
疫	疫	yèk
易	易	yèk
弋	弋	yèk
掖	掖	yèk
液	液	yèk
绎	繹	yèk
译	譯	yèk
翌	翌	yèk
逆	逆	yèk/ngàg
认	認	yènk
惹	惹	yé
野	野	yé
冶	冶	yé
郢	郢	yénk
应	應	yênk
亿	億	yëk
臆	臆	yëk
益	益	yëk
抑	抑	yëk
忆	憶	yëk
阋	鬩	yëk
婴	嬰	yënk
鹰	鷹	yënk
鹦	鸚	yënk
英	英	yënk
樱	櫻	yënk
应	應	yënk
缨	纓	yënk
膺	膺	yënk
瑛	瑛	yënk
二	二	yì
易	易	yì
肄	肄	yì
异	異	yì
贰	貳	yì
劓	劓	yì
义	義	yì
页	頁	yìb
业	業	yìb
叶	葉	yìb
烨	燁	yìb
拽	拽	yìd
孽	孽	yìd
热	熱	yìd
臬	臬	yìd/nìb
焰	焰	yìm
验	驗	yìm
艳	艷	yìm
谳	讞	yìn
现	現	yìn
砚	硯	yìn
谚	諺	yìn
苋	莧	yìn
彦	彥	yìn
唁	唁	yìn
曜	曜	yìu
鹞	鷂	yìu
耀	耀	yìu
迩	邇	yí
以	以	yí
洱	洱	yí
尔	爾	yí
耳	耳	yí
议	議	yí
迤	迤	yí
已	已	yí
拟	擬	yí
矣	矣	yí
染	染	yím
苒	苒	yím
俨	儼	yím
冉	冉	yím
舀	舀	yíu
癔	癔	yî
镱	鐿	yî
懿	懿	yî
意	意	yî
薏	薏	yî
靥	靨	yîb
噎	噎	yîd
谒	謁	yîd
咽	咽	yîd
餍	饜	yîm
厌	厭	yîm
咽	嚥	yîn
宴	宴	yîn
燕	燕	yîn
要	要	yîu
铱	銥	yï
漪	漪	yï
医	醫	yï
衣	衣	yï
依	依	yï
伊	伊	yï
黟	黟	yï
祎	禕	yï
祎	禕	yï
猗	猗	yï
奄	奄	yïm
淹	淹	yïm
阉	閹	yïm
恹	懨	yïm
腌	醃	yïm/yîb
蔫	蔫	yïn
湮	湮	yïn
烟	菸	yïn
胭	胭	yïn
焉	焉	yïn
咽	咽	yïn
鄢	鄢	yïn
嫣	嫣	yïn
燕	燕	yïn
烟	煙	yïn
阏	閼	yïn
要	要	yïu
吆	吆	yïu
邀	邀	yïu
夭	夭	yïu
幺	么	yïu
腰	腰	yïu
妖	妖	yïu
钰	鈺	yòk
褥	褥	yòk
蓐	蓐	yòk
浴	浴	yòk
辱	辱	yòk
育	育	yòk
狱	獄	yòk
肉	肉	yòk
鬻	鬻	yòk
缛	縟	yòk
欲	慾	yòk
玉	玉	yòk
欲	欲	yòk
峪	峪	yòk/yeù
用	用	yònk
润	潤	yònt
闰	閏	yònt
裔	裔	yòy
锐	銳	yòy
芮	芮	yòy
睿	睿	yòy
勇	勇	yónk
蕊	蕊	yóy
踊	踴	yõnk
蛹	蛹	yõnk
臃	臃	yõnk
涌	湧	yõnk
佣	佣	yõnk
俑	俑	yõnk
恿	慂	yõnk
拥	擁	yõnk
冗	冗	yõnk
哟	喲	yö
唷	唷	yö
煜	煜	yök
顼	頊	yök
旭	旭	yök
毓	毓	yök
郁	郁	yök
彧	彧	yök
昱	昱	yök
沃	沃	yök
饔	饔	yönk
翁	翁	yönk
雍	雍	yönk
嗡	嗡	yönk
邕	邕	yönk
廱	廱	yönk
倚	倚	yĩ
椅	椅	yĩ
绮	綺	yĩ
旖	旖	yĩ
齮	齮	yĩ
魇	魘	yĩm
掩	掩	yĩm
偃	偃	yĩn
兖	兗	yĩn
演	演	yĩn
鼹	鼴	yĩn
堰	堰	yĩn
衍	衍	yĩn/hĩn
窈	窈	yĩu
夭	夭	yĩu
扰	擾	yĩu
绕	繞	yĩu/yíu
影	影	yẽnk
映	映	yẽnk
氩	氬	â
啊	啊	â
娅	婭	â
亚	亞	â
阿	阿	â
鸭	鴨	âb
揠	揠	âd
轧	軋	âd
猰	猰	âd
压	壓	âd
遏	遏	âd
押	押	âd
隘	隘	âi
暗	暗	âmp
晏	晏	ân
拗	拗	âu
坳	坳	âu/äu
怄	慪	âw
凹	凹	âw/näp
屃	屭	ây
唉	唉	ây
缢	縊	ây
哑	啞	ã
啊	啊	ã
黯	黯	ãmp
揞	揞	ãmp
俺	俺	ãn
呕	嘔	ãw
殴	毆	ãw/äw
矮	矮	ãy
呀	呀	ä
吖	吖	ä
鸦	鴉	ä
啊	啊	ä
锕	錒	ä
丫	丫	ä
轭	軛	äg
挨	挨	äi
厄	厄	äk/äg
渥	渥	äk/äg
龌	齷	äk/äg
握	握	äk/äg
扼	扼	äk/äg
幄	幄	äk/äg
谙	諳	ämp
鹌	鵪	ämp
庵	庵	ämp
罂	罌	äng
莺	鶯	änk
罂	罌	änk
瓯	甌	äw
欧	歐	äw
鸥	鷗	äw
唉	唉	äy
哎	哎	äy
欸	欸	èy
欸	欸	ëy
嗯	嗯	ñg
哦	哦	ò
恶	惡	ôg
垩	堊	ôg
恶	噁	ôg
瑷	璦	ôi
爱	愛	ôi
摁	摁	ôn
案	案	ôn
按	按	ôn
瓮	甕	ônk
齆	齆	ônk
蔼	藹	õi
暧	曖	õi
叆	靉	õi
毐	毐	õi
媪	媼	õw
阿	阿	ö
珂	珂	ö
柯	柯	ö
轲	軻	ö
喔	喔	ö
噢	噢	ö
婀	婀	ö
哀	哀	öi
埃	埃	öi
屋	屋	ök
铵	銨	ön
桉	桉	ön
氨	氨	ön
安	安	ön
胺	胺	ön
鞍	鞍	ön
忤	忤	ńg
午	午	ńg
伍	伍	ńg
牾	牾	ńg
五	五	ńg
晤	晤	ǹg
焐	焐	ǹg
误	誤	ǹg
悟	悟	ǹg
捂	摀	ǹg
嗯	嗯	ǹg
欸	欸	ẽy
