開放粵語字典（黃錫凌調符調號版）

© 2013年 kaifangcidian.com
網址：http://www.kaifangcidian.com
本字典以創作共用“署名 3.0”許可協議授權發佈（詳見 http://creativecommons.org/licenses/by/3.0/）
最後更新於2013年1月22日

［繁體字］	［簡體字］	［黃錫凌拼音］

丫	丫	'a
呀	呀	'a
啊	啊	'a
錒	锕	'a
吖	吖	'a
鴉	鸦	'a
挨	挨	'ai
軛	轭	'ak
罌	罂	'aŋ
巴	巴	'ba
爸	爸	'ba
葩	葩	'ba
叭	叭	'ba
粑	粑	'ba
芭	芭	'ba
笆	笆	'ba
疤	疤	'ba
掰	掰	'bai/¯mak
迫	迫	'bak/'bik
班	班	'ban
瘢	瘢	'ban
頒	颁	'ban
斑	斑	'ban
包	包	'bau
褒	褒	'bau
苞	苞	'bau
胞	胞	'bau
鮑	鲍	'bau
孢	孢	'bau
裨	裨	'bei
卑	卑	'bei
悲	悲	'bei
屄	屄	'bei
碑	碑	'bei
逼	逼	'bik
愎	愎	'bik
璧	璧	'bik
壁	壁	'bik
碧	碧	'bik
辮	辫	'bin
鞭	鞭	'bin
邊	边	'bin
觱	觱	'bit
必	必	'bit
鑣	镳	'biu
標	标	'biu
錶	表	'biu
鏢	镖	'biu
彪	彪	'biu
膘	膘	'biu
飆	飙	'biu
晡	晡	'bou
杯	杯	'bui
搬	搬	'bun
般	般	'bun
跛	跛	'bɐi/´bɔ
北	北	'bɐk
泵	泵	'bɐm
乓	乓	'bɐm/'pɔŋ
濱	滨	'bɐn
彬	彬	'bɐn
斌	斌	'bɐn
檳	槟	'bɐn
繽	缤	'bɐn
賓	宾	'bɐn
奔	奔	'bɐn
瀕	濒	'bɐn/ˌpɐn
畢	毕	'bɐt
筆	笔	'bɐt
嗶	哔	'bɐt
篳	筚	'bɐt
不	不	'bɐt
鈈	钚	'bɐt
蹕	跸	'bɐt
蓽	荜	'bɐt
鏰	镚	'bɐŋ
崩	崩	'bɐŋ
菠	菠	'bɔ
玻	玻	'bɔ
波	波	'bɔ
幫	帮	'bɔŋ
邦	邦	'bɔŋ
梆	梆	'bɔŋ
啤	啤	'bɛ
冰	冰	'bɪŋ
兵	兵	'bɪŋ
乒	乒	'bɪŋ/'pɪŋ
卜	卜	'bʊk
呆	呆	'dai
儋	儋	'dam
擔	担	'dam
聃	聃	'dam
眈	眈	'dam
耽	耽	'dam
丹	丹	'dan
殫	殚	'dan
單	单	'dan
鄲	郸	'dan
的	的	'dik
滴	滴	'dik
嫡	嫡	'dik
掂	掂	'dim
顛	颠	'din
巔	巅	'din
碘	碘	'din
癲	癫	'din
丟	丢	'diu
刁	刁	'diu
碉	碉	'diu
凋	凋	'diu
雕	雕	'diu
鯛	鲷	'diu
叼	叼	'diu
貂	貂	'diu
都	都	'dou
嘟	嘟	'dou
叨	叨	'dou
刀	刀	'dou
端	端	'dyn
渣	渣	'dza
糌	糌	'dza
咱	咱	'dza
齇	齇	'dza
楂	楂	'dza
吒	吒	'dza
抓	抓	'dza/´dzau
齎	赍	'dzai
齋	斋	'dzai
嘲	嘲	'dzau
咨	咨	'dzi
茲	兹	'dzi
孜	孜	'dzi
滋	滋	'dzi
吱	吱	'dzi
氏	氏	'dzi
知	知	'dzi
支	支	'dzi
脂	脂	'dzi
蜘	蜘	'dzi
淄	淄	'dzi
輜	辎	'dzi
枝	枝	'dzi
肢	肢	'dzi
芝	芝	'dzi
齜	龇	'dzi
諮	谘	'dzi
鼒	鼒	'dzi
資	资	'dzi
貲	赀	'dzi
之	之	'dzi
姿	姿	'dzi
織	织	'dzik
跡	迹	'dzik
績	绩	'dzik
陟	陟	'dzik
積	积	'dzik
稷	稷	'dzik
鯽	鲫	'dzik
即	即	'dzik
職	职	'dzik
漬	渍	'dzik/¯dzi
占	占	'dzim
瞻	瞻	'dzim
沾	沾	'dzim
詹	詹	'dzim
尖	尖	'dzim
譫	谵	'dzim
霑	霑	'dzim
箋	笺	'dzin
氈	毡	'dzin
羶	膻	'dzin
煎	煎	'dzin
唧	唧	'dzit
朝	朝	'dziu
招	招	'dziu
礁	礁	'dziu
焦	焦	'dziu
椒	椒	'dziu
蕉	蕉	'dziu
糟	糟	'dzou
遭	遭	'dzou
租	租	'dzou
誅	诛	'dzy
銖	铢	'dzy
朱	朱	'dzy
諸	诸	'dzy
侏	侏	'dzy
茱	茱	'dzy
株	株	'dzy
豬	猪	'dzy
蛛	蛛	'dzy
珠	珠	'dzy
顓	颛	'dzyn
專	专	'dzyn
尊	尊	'dzyn
磚	砖	'dzyn
鱒	鳟	'dzyn/¯dzyn
鐫	镌	'dzyn/¯dzœn
榛	榛	'dzœn
臻	臻	'dzœn
津	津	'dzœn
樽	樽	'dzœn
諄	谆	'dzœn
遵	遵	'dzœn/'dzyn
卒	卒	'dzœt
怵	怵	'dzœt
黜	黜	'dzœt
追	追	'dzœy
椎	椎	'dzœy
錐	锥	'dzœy
狙	狙	'dzœy
蛆	蛆	'dzœy/'tsœy
章	章	'dzœŋ
漿	浆	'dzœŋ
漳	漳	'dzœŋ
嫜	嫜	'dzœŋ
獐	獐	'dzœŋ
張	张	'dzœŋ
彰	彰	'dzœŋ
樟	樟	'dzœŋ
璋	璋	'dzœŋ
蟑	蟑	'dzœŋ
將	将	'dzœŋ
鄣	鄣	'dzœŋ
齏	齑	'dzɐi
躋	跻	'dzɐi
擠	挤	'dzɐi
劑	剂	'dzɐi
仄	仄	'dzɐk
則	则	'dzɐk
昃	昃	'dzɐk
側	侧	'dzɐk
針	针	'dzɐm
箴	箴	'dzɐm
砧	砧	'dzɐm
斟	斟	'dzɐm
簪	簪	'dzɐm
胗	胗	'dzɐn
珍	珍	'dzɐn
真	真	'dzɐn
汁	汁	'dzɐp
執	执	'dzɐp
質	质	'dzɐt
洲	洲	'dzɐu
謅	诌	'dzɐu
周	周	'dzɐu
州	州	'dzɐu
舟	舟	'dzɐu
鄒	邹	'dzɐu
諏	诹	'dzɐu
輈	辀	'dzɐu
揪	揪	'dzɐu
週	周	'dzɐu
陬	陬	'dzɐu
憎	憎	'dzɐŋ
曾	曾	'dzɐŋ
箏	筝	'dzɐŋ
增	增	'dzɐŋ
崢	峥	'dzɐŋ
錚	铮	'dzɐŋ
僧	僧	'dzɐŋ
掙	挣	'dzɐŋ/'dzaŋ
爭	争	'dzɐŋ/'dzaŋ
猙	狰	'dzɐŋ/'dzaŋ
睜	睁	'dzɐŋ/'dzaŋ
災	灾	'dzɔi
栽	栽	'dzɔi
哉	哉	'dzɔi
妝	妆	'dzɔŋ
莊	庄	'dzɔŋ
裝	装	'dzɔŋ
髒	脏	'dzɔŋ
贓	赃	'dzɔŋ
樁	桩	'dzɔŋ
嗟	嗟	'dzɛ
遮	遮	'dzɛ
晶	晶	'dzɪŋ
蒸	蒸	'dzɪŋ
癥	症	'dzɪŋ
偵	侦	'dzɪŋ
烝	烝	'dzɪŋ
旌	旌	'dzɪŋ
睛	睛	'dzɪŋ
菁	菁	'dzɪŋ
精	精	'dzɪŋ
徵	征	'dzɪŋ
禎	祯	'dzɪŋ
征	征	'dzɪŋ
怔	怔	'dzɪŋ
貞	贞	'dzɪŋ
鉦	钲	'dzɪŋ
正	正	'dzɪŋ
足	足	'dzʊk
祝	祝	'dzʊk
粥	粥	'dzʊk
捉	捉	'dzʊk
矚	瞩	'dzʊk
燭	烛	'dzʊk
囑	嘱	'dzʊk
築	筑	'dzʊk
竹	竹	'dzʊk
竺	竺	'dzʊk
螽	螽	'dzʊŋ
鬃	鬃	'dzʊŋ
中	中	'dzʊŋ
忠	忠	'dzʊŋ
鍾	钟	'dzʊŋ
棕	棕	'dzʊŋ
宗	宗	'dzʊŋ
樅	枞	'dzʊŋ
鐘	钟	'dzʊŋ
蹤	踪	'dzʊŋ
盅	盅	'dzʊŋ
縱	纵	'dzʊŋ
終	终	'dzʊŋ
衷	衷	'dzʊŋ/'tsʊŋ
綜	综	'dzʊŋ/¯dzʊŋ
敦	敦	'dœn
惇	惇	'dœn
蹲	蹲	'dœn
墩	墩	'dœn
咄	咄	'dœt
堆	堆	'dœy
低	低	'dɐi
得	得	'dɐk
德	德	'dɐk
兜	兜	'dɐu
噔	噔	'dɐŋ
燈	灯	'dɐŋ
登	登	'dɐŋ
蹬	蹬	'dɐŋ
哆	哆	'dɔ
多	多	'dɔ
鐺	铛	'dɔŋ
襠	裆	'dɔŋ
噹	当	'dɔŋ
當	当	'dɔŋ
爹	爹	'dɛ
仃	仃	'dɪŋ
丁	丁	'dɪŋ
町	町	'dɪŋ
汀	汀	'dɪŋ
叮	叮	'dɪŋ/'dɛŋ
盯	盯	'dɪŋ/'dɛŋ
釘	钉	'dɪŋ/'dɛŋ
督	督	'dʊk
篤	笃	'dʊk
咚	咚	'dʊŋ
冬	冬	'dʊŋ
氡	氡	'dʊŋ
東	东	'dʊŋ
欸	欸	'ei
花	花	'fa
翻	翻	'fan
番	番	'fan
幡	幡	'fan
旛	旛	'fan
鯡	鲱	'fei
菲	菲	'fei
妃	妃	'fei
霏	霏	'fei
非	非	'fei
飛	飞	'fei
扉	扉	'fei
蜚	蜚	'fei
緋	绯	'fei
呼	呼	'fu
軤	轷	'fu
骷	骷	'fu
夫	夫	'fu
膚	肤	'fu
孵	孵	'fu
麩	麸	'fu
敷	敷	'fu
枯	枯	'fu
孚	孚	'fu
俘	俘	'fu
詼	诙	'fui
灰	灰	'fui
魁	魁	'fui
恢	恢	'fui
奎	奎	'fui/'kwɐi
寬	宽	'fun
歡	欢	'fun
髖	髋	'fun
貛	獾	'fun
揮	挥	'fɐi
撝	撝	'fɐi
暉	晖	'fɐi
徽	徽	'fɐi
輝	辉	'fɐi
紛	纷	'fɐn
婚	婚	'fɐn
薰	薰	'fɐn
氛	氛	'fɐn
勳	勋	'fɐn
吩	吩	'fɐn
芬	芬	'fɐn
酚	酚	'fɐn
昏	昏	'fɐn
葷	荤	'fɐn
分	分	'fɐn
燻	熏	'fɐn
熏	熏	'fɐn
醺	醺	'fɐn
彿	佛	'fɐt
惚	惚	'fɐt
笏	笏	'fɐt
氟	氟	'fɐt
窟	窟	'fɐt
囫	囫	'fɐt
忽	忽	'fɐt
弗	弗	'fɐt
拂	拂	'fɐt
科	科	'fɔ
蝌	蝌	'fɔ
邡	邡	'fɔŋ
坊	坊	'fɔŋ
謊	谎	'fɔŋ
慌	慌	'fɔŋ
肪	肪	'fɔŋ
方	方	'fɔŋ
荒	荒	'fɔŋ
芳	芳	'fɔŋ
啡	啡	'fɛ
輻	辐	'fʊk
複	复	'fʊk
腹	腹	'fʊk
覆	覆	'fʊk
福	福	'fʊk
幅	幅	'fʊk
馥	馥	'fʊk
蝠	蝠	'fʊk
蝮	蝮	'fʊk
風	风	'fʊŋ
封	封	'fʊŋ
蜂	蜂	'fʊŋ
鋒	锋	'fʊŋ
豐	丰	'fʊŋ
烽	烽	'fʊŋ
丰	丰	'fʊŋ
楓	枫	'fʊŋ
瘋	疯	'fʊŋ
峰	峰	'fʊŋ
伽	伽	'ga
袈	袈	'ga
枷	枷	'ga
家	家	'ga
傢	家	'ga
噶	噶	'ga
嘉	嘉	'ga
痂	痂	'ga
鎵	镓	'ga
加	加	'ga
迦	迦	'ga
珈	珈	'ga
佳	佳	'gai
偕	偕	'gai
街	街	'gai
階	阶	'gai
皆	皆	'gai
秸	秸	'gai
監	监	'gam
緘	缄	'gam
尷	尴	'gam/¯gam
姦	奸	'gan
艱	艰	'gan
間	间	'gan
奸	奸	'gan
跤	跤	'gau
蛟	蛟	'gau
交	交	'gau
郊	郊	'gau
茭	茭	'gau
膠	胶	'gau
耕	耕	'gaŋ
更	更	'gaŋ
磯	矶	'gei
乩	乩	'gei
箕	箕	'gei
奇	奇	'gei
幾	几	'gei
機	机	'gei
肌	肌	'gei
基	基	'gei
璣	玑	'gei
畿	畿	'gei
几	几	'gei
覊	羁	'gei
譏	讥	'gei
畸	畸	'gei
姬	姬	'gei
飢	饥	'gei
犄	犄	'gei
嘰	叽	'gei
戟	戟	'gik
擊	击	'gik
棘	棘	'gik
亟	亟	'gik
殛	殛	'gik
激	激	'gik
鶼	鹣	'gim
搛	搛	'gim
兼	兼	'gim
堅	坚	'gin
犍	犍	'gin
肩	肩	'gin
嬌	娇	'giu
驕	骄	'giu
羔	羔	'gou
膏	膏	'gou
糕	糕	'gou
皋	皋	'gou
高	高	'gou
睾	睾	'gou
姑	姑	'gu
沽	沽	'gu
蛄	蛄	'gu
軲	轱	'gu
咕	咕	'gu
孤	孤	'gu
辜	辜	'gu
觚	觚	'gu
菇	菇	'gu
冠	冠	'gun
官	官	'gun
棺	棺	'gun
倌	倌	'gun
莞	莞	'gun
觀	观	'gun
瓜	瓜	'gwa
呱	呱	'gwa
乖	乖	'gwai
關	关	'gwan
鰥	鳏	'gwan
虢	虢	'gwik
隙	隙	'gwik/'kwɪŋ
龜	龟	'gwɐi
瑰	瑰	'gwɐi
鮭	鲑	'gwɐi
皈	皈	'gwɐi
硅	硅	'gwɐi
圭	圭	'gwɐi
歸	归	'gwɐi
閨	闺	'gwɐi
均	均	'gwɐn
軍	军	'gwɐn
綸	纶	'gwɐn
君	君	'gwɐn
筠	筠	'gwɐn
鋆	鋆	'gwɐn
錕	锟	'gwɐn
鯤	鲲	'gwɐn
鈞	钧	'gwɐn
橘	橘	'gwɐt
骨	骨	'gwɐt
轟	轰	'gwɐŋ
訇	訇	'gwɐŋ
薨	薨	'gwɐŋ
肱	肱	'gwɐŋ
戈	戈	'gwɔ
桄	桄	'gwɔŋ
光	光	'gwɔŋ
胱	胱	'gwɔŋ
娟	娟	'gyn
捐	捐	'gyn
鵑	鹃	'gyn
蠲	蠲	'gyn
涓	涓	'gyn
据	据	'gœy
居	居	'gœy
僵	僵	'gœŋ
疆	疆	'gœŋ
韁	缰	'gœŋ
薑	姜	'gœŋ
姜	姜	'gœŋ
蜣	蜣	'gœŋ
殭	僵	'gœŋ
羌	羌	'gœŋ
雞	鸡	'gɐi
今	今	'gɐm
柑	柑	'gɐm
苷	苷	'gɐm
甘	甘	'gɐm
泔	泔	'gɐm
金	金	'gɐm
禁	禁	'gɐm
哏	哏	'gɐn
筋	筋	'gɐn
跟	跟	'gɐn
根	根	'gɐn
巾	巾	'gɐn
斤	斤	'gɐn
急	急	'gɐp
訖	讫	'gɐt
桔	桔	'gɐt
紇	纥	'gɐt
吉	吉	'gɐt
佝	佝	'gɐu
鬮	阄	'gɐu
鉤	钩	'gɐu
鳩	鸠	'gɐu/'kɐu
庚	庚	'gɐŋ
更	更	'gɐŋ
羹	羹	'gɐŋ
哥	哥	'gɔ
仡	仡	'gɔ
歌	歌	'gɔ
旮	旮	'gɔ/¯gɔk
菏	菏	'gɔ/ˌhɔ
賅	赅	'gɔi
該	该	'gɔi
咯	咯	'gɔk
杆	杆	'gɔn
乾	干	'gɔn
干	干	'gɔn
竿	竿	'gɔn
肝	肝	'gɔn
崗	岗	'gɔŋ
肛	肛	'gɔŋ
罡	罡	'gɔŋ
缸	缸	'gɔŋ
剛	刚	'gɔŋ
江	江	'gɔŋ
綱	纲	'gɔŋ
岡	冈	'gɔŋ
驚	惊	'gɛŋ
京	京	'gɪŋ
驚	惊	'gɪŋ
經	经	'gɪŋ
涇	泾	'gɪŋ
兢	兢	'gɪŋ
荊	荆	'gɪŋ
矜	矜	'gɪŋ
谷	谷	'gʊk
轂	毂	'gʊk
穀	谷	'gʊk
鞠	鞠	'gʊk
梏	梏	'gʊk
嚳	嚳	'gʊk
菊	菊	'gʊk
鵠	鹄	'gʊk
掬	掬	'gʊk
宮	宫	'gʊŋ
攻	攻	'gʊŋ
工	工	'gʊŋ
功	功	'gʊŋ
公	公	'gʊŋ
躬	躬	'gʊŋ
龔	龚	'gʊŋ
蚣	蚣	'gʊŋ
弓	弓	'gʊŋ
供	供	'gʊŋ
恭	恭	'gʊŋ
哈	哈	'ha
蝦	虾	'ha
揩	揩	'hai
嗨	嗨	'hai
赫	赫	'hak
哮	哮	'hau
敲	敲	'hau
烤	烤	'hau/´hau
夯	夯	'haŋ
坑	坑	'haŋ
熙	熙	'hei
嬉	嬉	'hei
醯	醯	'hei
浠	浠	'hei
熹	熹	'hei
欺	欺	'hei
羲	羲	'hei
唏	唏	'hei
嘻	嘻	'hei
希	希	'hei
稀	稀	'hei
欷	欷	'hei
禧	禧	'hei
犧	牺	'hei
嘿	嘿	'hei
烯	烯	'hei
曦	曦	'hei
謙	谦	'him
掀	掀	'hin
牽	牵	'hin
軒	轩	'hin
騫	骞	'hin
囂	嚣	'hiu
梟	枭	'hiu
驍	骁	'hiu
鴞	鸮	'hiu
僥	侥	'hiu
澆	浇	'hiu
橇	橇	'hiu/¯tsœy
蒿	蒿	'hou
薅	薅	'hou
壎	埙	'hyn
萱	萱	'hyn
圈	圈	'hyn
暄	暄	'hyn
喧	喧	'hyn
吁	吁	'hœy
墟	墟	'hœy
歔	歔	'hœy
噓	嘘	'hœy
盱	盱	'hœy
虛	虚	'hœy
鄉	乡	'hœŋ
香	香	'hœŋ
氪	氪	'hɐk
可	可	'hɐk
克	克	'hɐk
刻	刻	'hɐk
黑	黑	'hɐk
剋	克	'hɐk
堪	堪	'hɐm
戡	戡	'hɐm
憨	憨	'hɐm
勘	勘	'hɐm
蚶	蚶	'hɐm
龕	龛	'hɐm
洽	洽	'hɐp
恰	恰	'hɐp
乞	乞	'hɐt
齁	齁	'hɐu
亨	亨	'hɐŋ
哼	哼	'hɐŋ
鏗	铿	'hɐŋ
莖	茎	'hɐŋ/¯gɪŋ
訶	诃	'hɔ
苛	苛	'hɔ
呵	呵	'hɔ
開	开	'hɔi
鐦	锎	'hɔi
咍	咍	'hɔi
腔	腔	'hɔŋ
糠	糠	'hɔŋ
誆	诓	'hɔŋ
匡	匡	'hɔŋ
劻	劻	'hɔŋ
康	康	'hɔŋ
筐	筐	'hɔŋ/'kwaŋ
眶	眶	'hɔŋ/'kwaŋ
靴	靴	'hɛu
馨	馨	'hɪŋ
卿	卿	'hɪŋ
氫	氢	'hɪŋ
兄	兄	'hɪŋ
興	兴	'hɪŋ
輕	轻	'hɪŋ/'hɛŋ
哭	哭	'hʊk
凶	凶	'hʊŋ
洶	汹	'hʊŋ
崆	崆	'hʊŋ
兇	凶	'hʊŋ
匈	匈	'hʊŋ
箜	箜	'hʊŋ
空	空	'hʊŋ
胸	胸	'hʊŋ
衣	衣	'ji
醫	医	'ji
依	依	'ji
伊	伊	'ji
銥	铱	'ji
禕	祎	'ji
禕	祎	'ji
猗	猗	'ji
漪	漪	'ji
黟	黟	'ji
益	益	'jik
鬩	阋	'jik
憶	忆	'jik
臆	臆	'jik
抑	抑	'jik
億	亿	'jik
淹	淹	'jim
奄	奄	'jim
閹	阉	'jim
懨	恹	'jim
醃	腌	'jim/¯jip
鄢	鄢	'jin
閼	阏	'jin
蔫	蔫	'jin
菸	烟	'jin
嫣	嫣	'jin
燕	燕	'jin
咽	咽	'jin
湮	湮	'jin
焉	焉	'jin
胭	胭	'jin
煙	烟	'jin
妖	妖	'jiu
腰	腰	'jiu
夭	夭	'jiu
邀	邀	'jiu
么	幺	'jiu
吆	吆	'jiu
要	要	'jiu
淤	淤	'jy
迂	迂	'jy
於	于	'jy
淵	渊	'jyn
鴛	鸳	'jyn
鳶	鸢	'jyn
冤	冤	'jyn
蜿	蜿	'jyn
央	央	'jœŋ
殃	殃	'jœŋ
秧	秧	'jœŋ
鴦	鸯	'jœŋ
音	音	'jɐm
欽	钦	'jɐm
鑫	鑫	'jɐm
陰	阴	'jɐm
歆	歆	'jɐm
氤	氤	'jɐn
因	因	'jɐn
堙	堙	'jɐn
甄	甄	'jɐn
忻	忻	'jɐn
殷	殷	'jɐn
姻	姻	'jɐn
欣	欣	'jɐn
昕	昕	'jɐn
茵	茵	'jɐn
恩	恩	'jɐn
邑	邑	'jɐp
挹	挹	'jɐp
翕	翕	'jɐp
熠	熠	'jɐp
泣	泣	'jɐp
揖	揖	'jɐp
悒	悒	'jɐp
壹	壹	'jɐt
一	一	'jɐt
咻	咻	'jɐu
休	休	'jɐu
幽	幽	'jɐu
憂	忧	'jɐu
丘	丘	'jɐu
鵂	鸺	'jɐu
邱	邱	'jɐu
優	优	'jɐu
貅	貅	'jɐu
蚯	蚯	'jɐu
髹	髹	'jɐu
喲	哟	'jɔ
唷	唷	'jɔ
膺	膺	'jɪŋ
鷹	鹰	'jɪŋ
瑛	瑛	'jɪŋ
鸚	鹦	'jɪŋ
纓	缨	'jɪŋ
櫻	樱	'jɪŋ
英	英	'jɪŋ
嬰	婴	'jɪŋ
應	应	'jɪŋ
郁	郁	'jʊk
煜	煜	'jʊk
頊	顼	'jʊk
毓	毓	'jʊk
彧	彧	'jʊk
昱	昱	'jʊk
沃	沃	'jʊk
旭	旭	'jʊk
雍	雍	'jʊŋ
翁	翁	'jʊŋ
嗡	嗡	'jʊŋ
饔	饔	'jʊŋ
廱	廱	'jʊŋ
邕	邕	'jʊŋ
卡	卡	'ka
喀	喀	'ka
蹊	蹊	'kei
崎	崎	'kei
蹺	跷	'kiu/'hiu
箍	箍	'ku
誇	夸	'kwa
垮	垮	'kwa
夸	夸	'kwa
框	框	'kwaŋ/'hɔŋ
盔	盔	'kwɐi
虧	亏	'kwɐi
巋	岿	'kwɐi
規	规	'kwɐi
窺	窥	'kwɐi
崑	昆	'kwɐn
坤	坤	'kwɐn
髡	髡	'kwɐn
昆	昆	'kwɐn
焜	焜	'kwɐn/_wɐn
嶇	岖	'kœy
祛	祛	'kœy
駒	驹	'kœy
俱	俱	'kœy
軀	躯	'kœy
驅	驱	'kœy
區	区	'kœy
拘	拘	'kœy
蹊	蹊	'kɐi
稽	稽	'kɐi
溪	溪	'kɐi
嵇	嵇	'kɐi/ˌhɐi
襟	襟	'kɐm
吸	吸	'kɐp
給	给	'kɐp
岌	岌	'kɐp
級	级	'kɐp
笈	笈	'kɐp
歙	歙	'kɐp
汲	汲	'kɐp
咳	咳	'kɐt
卡	卡	'kɐt
摳	抠	'kɐu
篝	篝	'kɐu/'gɐu
溝	沟	'kɐu/'gɐu
扛	扛	'kɔŋ
傾	倾	'kɪŋ
曲	曲	'kʊk
麴	曲	'kʊk
拉	拉	'la
啦	啦	'la
喇	喇	'la
拉	拉	'lai
喱	喱	'lei
璃	璃	'lei
哩	哩	'li
櫪	枥	'lik
礫	砾	'lik
靂	雳	'lik
瀝	沥	'lik/_lik
令	令	'lim
撂	撂	'liu
撩	撩	'liu
溜	溜	'liu
撈	捞	'lou
嚕	噜	'lou
笠	笠	'lɐp
甩	甩	'lɐt
嘍	喽	'lɐu
囉	囉	'lɔ
咯	咯	'lɔ
旯	旯	'lɔ/¯lɔk
啷	啷	'lɔŋ
哩	哩	'lɛ
咧	咧	'lɛ
轆	辘	'lʊk
麓	麓	'lʊk
碌	碌	'lʊk
嬤	嬷	'ma
媽	妈	'ma
嗎	吗	'ma/¯ma
貓	猫	'mau
繃	绷	'maŋ
喵	喵	'miu
咪	咪	'mɐi/'mei
蚊	蚊	'mɐn
哞	哞	'mɐu
摩	摩	'mɔ
麼	么	'mɔ
魔	魔	'mɔ
剝	剥	'mɔk
哶	哶	'mɛ
哪	哪	'na
孬	孬	'nau
匿	匿	'nik
暱	昵	'nik
溺	溺	'nik/_nik
拈	拈	'nim
粘	粘	'nim/'dzim
黏	黏	'nim/'dzim
鎳	镍	'nip
粒	粒	'nɐp/'lɐp
呢	呢	'nɛ
趴	趴	'pa
啪	啪	'pak
攀	攀	'pan
扳	扳	'pan
泡	泡	'pau
脬	脬	'pau
拋	抛	'pau
澎	澎	'paŋ
烹	烹	'paŋ
披	披	'pei
狉	狉	'pei
丕	丕	'pei
呸	呸	'pei
紕	纰	'pei
闢	辟	'pik
僻	僻	'pik
霹	霹	'pik
辟	辟	'pik
癖	癖	'pik
編	编	'pin
偏	偏	'pin
翩	翩	'pin
篇	篇	'pin
扁	扁	'pin
蝙	蝙	'pin/'bin
漂	漂	'piu
飄	飘	'piu
縹	缥	'piu
嘌	嘌	'piu
鋪	铺	'pou
坯	坯	'pui
胚	胚	'pui
番	番	'pun
潘	潘	'pun
批	批	'pɐi
疋	疋	'pɐt
匹	匹	'pɐt
頗	颇	'pɔ
坡	坡	'pɔ/'bɔ
棵	棵	'pɔ/´fɔ
怦	怦	'pɪŋ
抨	抨	'pɪŋ
姘	姘	'pɪŋ
砰	砰	'pɪŋ
娉	娉	'pɪŋ
拼	拼	'pɪŋ/¯pɪŋ
仆	仆	'pʊk
莎	莎	'sa
卅	卅	'sa
裟	裟	'sa
紗	纱	'sa
砂	砂	'sa
沙	沙	'sa
痧	痧	'sa
啥	啥	'sa
鯊	鲨	'sa
仨	仨	'sam
三	三	'sam
叄	叁	'sam
衫	衫	'sam
山	山	'san
栓	栓	'san
珊	珊	'san
舢	舢	'san
閂	闩	'san
姍	姗	'san
刪	删	'san
潸	潸	'san
拴	拴	'san
跚	跚	'san
梢	梢	'sau
捎	捎	'sau
牲	牲	'saŋ
甥	甥	'saŋ
尸	尸	'si
絲	丝	'si
師	师	'si
詩	诗	'si
廝	厮	'si
屍	尸	'si
思	思	'si
司	司	'si
私	私	'si
施	施	'si
斯	斯	'si
蓍	蓍	'si
撕	撕	'si
獅	狮	'si
飾	饰	'sik
淅	淅	'sik
蟋	蟋	'sik
悉	悉	'sik
螫	螫	'sik
皙	皙	'sik
晰	晰	'sik
識	识	'sik
惜	惜	'sik
銫	铯	'sik
式	式	'sik
析	析	'sik
昔	昔	'sik
軾	轼	'sik
熄	熄	'sik
色	色	'sik
適	适	'sik
媳	媳	'sik
嗇	啬	'sik
息	息	'sik
釋	释	'sik
蜥	蜥	'sik
拭	拭	'sik
鮮	鲜	'sin
先	先	'sin
酰	酰	'sin
仙	仙	'sin
氙	氙	'sin/'san
宵	宵	'siu
霄	霄	'siu
消	消	'siu
瀟	潇	'siu
魈	魈	'siu
簫	箫	'siu
逍	逍	'siu
硝	硝	'siu
蕭	萧	'siu
韶	韶	'siu
燒	烧	'siu
銷	销	'siu
穌	稣	'sou
囌	苏	'sou
臊	臊	'sou
騷	骚	'sou
搔	搔	'sou
鬚	须	'sou
酥	酥	'sou
蘇	苏	'sou
甦	甦	'sou
書	书	'sy
舒	舒	'sy
紓	纾	'sy
抒	抒	'sy
輸	输	'sy
樞	枢	'sy
瑄	瑄	'syn
孫	孙	'syn
猻	狲	'syn
宣	宣	'syn
酸	酸	'syn
狻	狻	'syn
蓀	荪	'syn
悛	悛	'syn
飧	飧	'syn
荀	荀	'sœn
芯	芯	'sœn
殉	殉	'sœn
詢	询	'sœn
峋	峋	'sœn
率	率	'sœt
戌	戌	'sœt
恤	恤	'sœt
摔	摔	'sœt
蟀	蟀	'sœt
衰	衰	'sœy
濉	濉	'sœy
綏	绥	'sœy
需	需	'sœy
胥	胥	'sœy
荽	荽	'sœy
須	须	'sœy
雖	虽	'sœy
睢	睢	'sœy
傷	伤	'sœŋ
殤	殇	'sœŋ
孀	孀	'sœŋ
觴	觞	'sœŋ
湘	湘	'sœŋ
箱	箱	'sœŋ
商	商	'sœŋ
廂	厢	'sœŋ
雙	双	'sœŋ
霜	霜	'sœŋ
襄	襄	'sœŋ
相	相	'sœŋ
鑲	镶	'sœŋ
鸘	鹴	'sœŋ
嘶	嘶	'sɐi
硒	硒	'sɐi
舾	舾	'sɐi
犀	犀	'sɐi
西	西	'sɐi
篩	筛	'sɐi
塞	塞	'sɐk
噻	噻	'sɐk
參	参	'sɐm
森	森	'sɐm
心	心	'sɐm
琛	琛	'sɐm
深	深	'sɐm
芯	芯	'sɐm
郴	郴	'sɐm
身	身	'sɐn
燊	燊	'sɐn
薪	薪	'sɐn
新	新	'sɐn
砷	砷	'sɐn
伸	伸	'sɐn
申	申	'sɐn
呻	呻	'sɐn
鋅	锌	'sɐn
娠	娠	'sɐn
辛	辛	'sɐn
莘	莘	'sɐn
紳	绅	'sɐn
濕	湿	'sɐp
澀	涩	'sɐp/'sik/¯gip
膝	膝	'sɐt
瑟	瑟	'sɐt
失	失	'sɐt
室	室	'sɐt
蝨	虱	'sɐt
螋	螋	'sɐu
颼	飕	'sɐu
羞	羞	'sɐu
嗖	嗖	'sɐu
餿	馊	'sɐu
收	收	'sɐu
修	修	'sɐu
搜	搜	'sɐu/´sɐu
笙	笙	'sɐŋ
生	生	'sɐŋ/'saŋ
唆	唆	'sɔ
疏	疏	'sɔ
蓑	蓑	'sɔ
蔬	蔬	'sɔ
嗦	嗦	'sɔ
羧	羧	'sɔ
梭	梭	'sɔ
梳	梳	'sɔ
鰓	鳃	'sɔi
腮	腮	'sɔi
桑	桑	'sɔŋ
喪	丧	'sɔŋ
些	些	'sɛ
星	星	'sɪŋ
惺	惺	'sɪŋ
陞	升	'sɪŋ
勝	胜	'sɪŋ
升	升	'sɪŋ
昇	升	'sɪŋ
猩	猩	'sɪŋ
聲	声	'sɪŋ/'sɛŋ
腥	腥	'sɪŋ/'sɛŋ
粟	粟	'sʊk
僳	僳	'sʊk
倏	倏	'sʊk
鷫	鹔	'sʊk
宿	宿	'sʊk
叔	叔	'sʊk
夙	夙	'sʊk
縮	缩	'sʊk
蓿	蓿	'sʊk
肅	肃	'sʊk
淞	淞	'sʊŋ
鬆	松	'sʊŋ
忪	忪	'sʊŋ
從	从	'sʊŋ
嵩	嵩	'sʊŋ
它	它	'ta
祂	他	'ta
他	他	'ta
她	她	'ta
牠	它	'ta
鉈	铊	'ta
貪	贪	'tam
坍	坍	'tan
癱	瘫	'tan
攤	摊	'tan
灘	滩	'tan
鋱	铽	'tik
忑	忑	'tik
惕	惕	'tik
倜	倜	'tik
忒	忒	'tik
剔	剔	'tik
添	添	'tim
天	天	'tin
挑	挑	'tiu
叨	叨	'tou
饕	饕	'tou
韜	韬	'tou
滔	滔	'tou
叉	叉	'tsa
差	差	'tsa
揣	揣	'tsai
搋	搋	'tsai
猜	猜	'tsai
釵	钗	'tsai
差	差	'tsai
參	参	'tsam
摻	掺	'tsam
攙	搀	'tsam
餐	餐	'tsan
鈔	钞	'tsau
抄	抄	'tsau
瞠	瞠	'tsaŋ
撐	撑	'tsaŋ
蚩	蚩	'tsi
差	差	'tsi
哧	哧	'tsi
眵	眵	'tsi
螭	螭	'tsi
疵	疵	'tsi
癡	痴	'tsi
跐	跐	'tsi
嗤	嗤	'tsi
笞	笞	'tsi
鴟	鸱	'tsi
魑	魑	'tsi
雌	雌	'tsi
彳	彳	'tsik
敕	敕	'tsik
叱	叱	'tsik
戚	戚	'tsik
斥	斥	'tsik
籤	签	'tsim
纖	纤	'tsim
簽	签	'tsim
殲	歼	'tsim
遷	迁	'tsin
阡	阡	'tsin
仟	仟	'tsin
韆	千	'tsin
千	千	'tsin
超	超	'tsiu
鍬	锹	'tsiu
昭	昭	'tsiu
釗	钊	'tsiu
粗	粗	'tsou
操	操	'tsou
躇	躇	'tsy
櫥	橱	'tsy
汆	汆	'tsyn
穿	穿	'tsyn
村	村	'tsyn
川	川	'tsyn
躥	蹿	'tsyn
春	春	'tsœn
齣	出	'tsœt
出	出	'tsœt
催	催	'tsœy
趨	趋	'tsœy
吹	吹	'tsœy
摧	摧	'tsœy
崔	崔	'tsœy
炊	炊	'tsœy
璀	璀	'tsœy/´tsœy
猖	猖	'tsœŋ
倀	伥	'tsœŋ
鏘	锵	'tsœŋ
菖	菖	'tsœŋ
娼	娼	'tsœŋ
槍	枪	'tsœŋ
鯧	鲳	'tsœŋ
戧	戗	'tsœŋ
嗆	呛	'tsœŋ
昌	昌	'tsœŋ
窗	窗	'tsœŋ
棲	栖	'tsɐi
悽	悽	'tsɐi
妻	妻	'tsɐi
淒	凄	'tsɐi
測	测	'tsɐk
惻	恻	'tsɐk
侵	侵	'tsɐm
參	参	'tsɐm/'tsam
瞋	瞋	'tsɐn
親	亲	'tsɐn
嗔	嗔	'tsɐn
葺	葺	'tsɐp
緝	缉	'tsɐp
輯	辑	'tsɐp
柒	柒	'tsɐt
漆	漆	'tsɐt
七	七	'tsɐt
秋	秋	'tsɐu
抽	抽	'tsɐu
鞦	秋	'tsɐu
鰍	鳅	'tsɐu
楸	楸	'tsɐu
磋	磋	'tsɔ
搓	搓	'tsɔ
芻	刍	'tsɔ
雛	雏	'tsɔ
初	初	'tsɔ
倉	仓	'tsɔŋ
滄	沧	'tsɔŋ
創	创	'tsɔŋ
傖	伧	'tsɔŋ
蒼	苍	'tsɔŋ
瘡	疮	'tsɔŋ
艙	舱	'tsɔŋ
車	车	'tsɛ
奢	奢	'tsɛ
稱	称	'tsɪŋ
清	清	'tsɪŋ
氰	氰	'tsɪŋ
蟶	蛏	'tsɪŋ
蜻	蜻	'tsɪŋ
鯖	鲭	'tsɪŋ
青	青	'tsɪŋ/'tsɛŋ
簇	簇	'tsʊk
亍	亍	'tsʊk
齪	龊	'tsʊk
蹴	蹴	'tsʊk
簌	簌	'tsʊk
畜	畜	'tsʊk
蹙	蹙	'tsʊk
矗	矗	'tsʊk
束	束	'tsʊk
搐	搐	'tsʊk
蓄	蓄	'tsʊk
促	促	'tsʊk
速	速	'tsʊk
觸	触	'tsʊk/'dzʊk
充	充	'tsʊŋ
憧	憧	'tsʊŋ
涌	涌	'tsʊŋ
囪	囱	'tsʊŋ
沖	冲	'tsʊŋ
蔥	葱	'tsʊŋ
驄	骢	'tsʊŋ
匆	匆	'tsʊŋ
樅	枞	'tsʊŋ
忡	忡	'tsʊŋ
聰	聪	'tsʊŋ
衝	冲	'tsʊŋ
湍	湍	'tœn/'dzyn
推	推	'tœy
銻	锑	'tɐi
梯	梯	'tɐi
吞	吞	'tɐn
飩	饨	'tɐn
偷	偷	'tɐu
拖	拖	'tɔ
苔	苔	'tɔi
胎	胎	'tɔi
湯	汤	'tɔŋ
汀	汀	'tɪŋ
烴	烃	'tɪŋ
聽	听	'tɪŋ/'tɛŋ
廳	厅	'tɪŋ/'tɛŋ
禿	秃	'tʊk
通	通	'tʊŋ
窪	洼	'wa
娃	娃	'wa
蛙	蛙	'wa
哇	哇	'wa
嘩	哗	'wa
譁	哗	'wa
凹	凹	'wa
歪	歪	'wai
灣	湾	'wan
彎	弯	'wan
鎢	钨	'wu
污	污	'wu
鄔	邬	'wu
烏	乌	'wu
嗚	呜	'wu
惡	恶	'wu
偎	偎	'wui
剜	剜	'wun
威	威	'wɐi
葳	葳	'wɐi
委	委	'wɐi
逶	逶	'wɐi
崴	崴	'wɐi
氳	氲	'wɐn
溫	温	'wɐn
瘟	瘟	'wɐn
屈	屈	'wɐt
鬱	郁	'wɐt
蝸	蜗	'wɔ
媧	娲	'wɔ
渦	涡	'wɔ
窩	窝	'wɔ
撾	挝	'wɔ
萵	莴	'wɔ
鍋	锅	'wɔ
倭	倭	'wɔ
窠	窠	'wɔ/'fɔ
汪	汪	'wɔŋ
扔	扔	'wɪŋ
勾	勾	'ŋɐu
骯	肮	'ŋɔŋ/¯ŋɔŋ
哎	哎	'ɐi
唉	唉	'ɐi
齷	龌	'ɐk/'ak
扼	扼	'ɐk/'ak
幄	幄	'ɐk/'ak
厄	厄	'ɐk/'ak
渥	渥	'ɐk/'ak
握	握	'ɐk/'ak
諳	谙	'ɐm
庵	庵	'ɐm
鵪	鹌	'ɐm
甌	瓯	'ɐu
歐	欧	'ɐu
鷗	鸥	'ɐu
鶯	莺	'ɐŋ
罌	罂	'ɐŋ
珂	珂	'ɔ
軻	轲	'ɔ
喔	喔	'ɔ
柯	柯	'ɔ
婀	婀	'ɔ
噢	噢	'ɔ
阿	阿	'ɔ
哀	哀	'ɔi
埃	埃	'ɔi
安	安	'ɔn
銨	铵	'ɔn
氨	氨	'ɔn
胺	胺	'ɔn
鞍	鞍	'ɔn
桉	桉	'ɔn
屋	屋	'ʊk
罷	罢	_ba
吧	吧	_ba
稗	稗	_bai
敗	败	_bai
白	白	_bak
蔔	卜	_bak
匐	匐	_bak
帛	帛	_bak
扮	扮	_ban
辦	办	_ban
茇	茇	_bat
齙	龅	_bau
鮑	鲍	_bau
蹦	蹦	_baŋ
繃	绷	_baŋ
箆	箆	_bei
備	备	_bei
鼻	鼻	_bei
避	避	_bei
被	被	_bei
憊	惫	_bei/_bai
辨	辨	_bin
辯	辩	_bin
便	便	_bin
卞	卞	_bin
別	别	_bit
蹩	蹩	_bit
癟	瘪	_bit
步	步	_bou
部	部	_bou
簿	簿	_bou
捕	捕	_bou
暴	暴	_bou
哺	哺	_bou
埠	埠	_bou/_fɐu
焙	焙	_bui
悖	悖	_bui
背	背	_bui
拌	拌	_bun
畔	畔	_bun
叛	叛	_bun
絆	绊	_bun
胖	胖	_bun
伴	伴	_bun/´pun
脖	脖	_but
撥	拨	_but
勃	勃	_but
荸	荸	_but
渤	渤	_but
弊	弊	_bɐi
陛	陛	_bɐi
斃	毙	_bɐi
狴	狴	_bɐi
幣	币	_bɐi
敝	敝	_bɐi
笨	笨	_bɐn
苾	苾	_bɐt
拔	拔	_bɐt
跋	跋	_bɐt
弼	弼	_bɐt
鈸	钹	_bɐt
菝	菝	_bɐt
薄	薄	_bɔk
礴	礴	_bɔk
箔	箔	_bɔk
泊	泊	_bɔk
鉑	铂	_bɔk
雹	雹	_bɔk
舶	舶	_bɔk/¯pak
磅	磅	_bɔŋ
鎊	镑	_bɔŋ
傍	傍	_bɔŋ
唄	呗	_bɛ
病	病	_bɛŋ/_bɪŋ
並	并	_bɪŋ
蹼	蹼	_bʊk
濮	濮	_bʊk
瀑	瀑	_bʊk
僕	仆	_bʊk
曝	曝	_bʊk
大	大	_dai
澹	澹	_dam
淡	淡	_dam
氮	氮	_dam
淡	淡	_dam/ˏtam
蛋	蛋	_dan
疍	疍	_dan
彈	弹	_dan
憚	惮	_dan
但	但	_dan
蹋	蹋	_dap
沓	沓	_dap
踏	踏	_dap
噠	哒	_dat
達	达	_dat
繨	繨	_dat
地	地	_dei
滌	涤	_dik
翟	翟	_dik
狄	狄	_dik
迪	迪	_dik
敵	敌	_dik
奠	奠	_din
佃	佃	_din
電	电	_din
澱	淀	_din
墊	垫	_din
殿	殿	_din
靛	靛	_din
甸	甸	_din
疊	叠	_dip
碟	碟	_dip
喋	喋	_dip
牒	牒	_dip
諜	谍	_dip
鰈	鲽	_dip
蝶	蝶	_dip
耋	耋	_dit
秩	秩	_dit
迭	迭	_dit
掉	掉	_diu
調	调	_diu
稻	稻	_dou
蹈	蹈	_dou
杜	杜	_dou
鍍	镀	_dou
道	道	_dou
悼	悼	_dou
渡	渡	_dou
導	导	_dou
度	度	_dou
盜	盗	_dou
緞	缎	_dyn
段	段	_dyn
斷	断	_dyn
斷	断	_dyn/¯dyn
奪	夺	_dyt
膪	膪	_dza
嵖	嵖	_dza
眥	眦	_dzai
寨	寨	_dzai
謫	谪	_dzak
宅	宅	_dzak
擇	择	_dzak
澤	泽	_dzak
摘	摘	_dzak
擲	掷	_dzak
躑	踯	_dzak
暫	暂	_dzam
站	站	_dzam
鏨	錾	_dzam
棧	栈	_dzan
綻	绽	_dzan
饌	馔	_dzan
賺	赚	_dzan
撰	撰	_dzan
襲	袭	_dzap
閘	闸	_dzap
集	集	_dzap
習	习	_dzap
隰	隰	_dzap
什	什	_dzap
雜	杂	_dzap
掙	挣	_dzaŋ
祀	祀	_dzi
字	字	_dzi
稚	稚	_dzi
痔	痔	_dzi
飼	饲	_dzi
嗣	嗣	_dzi
自	自	_dzi
治	治	_dzi
巳	巳	_dzi
雉	雉	_dzi
伺	伺	_dzi
耜	耜	_dzi
俟	俟	_dzi
豸	豸	_dzi/_dzai
寺	寺	_dzi/´dzi
峙	峙	_dzi/ˏtsi
籍	籍	_dzik
矽	矽	_dzik
寂	寂	_dzik
直	直	_dzik
汐	汐	_dzik
殖	殖	_dzik
植	植	_dzik
席	席	_dzik
值	值	_dzik
夕	夕	_dzik
藉	藉	_dzik
蓆	蓆	_dzik/_dzɛk
藉	借	_dzik/¯dzɛ
借	借	_dzik/¯dzɛ
漸	渐	_dzim
賤	贱	_dzin
捷	捷	_dzit
睫	睫	_dzit
截	截	_dzit
召	召	_dziu
趙	赵	_dziu
造	造	_dzou
皂	皂	_dzou
做	做	_dzou
慥	慥	_dzou/¯tsou
住	住	_dzy
箸	箸	_dzy
傳	传	_dzyn
絕	绝	_dzyt
著	著	_dzœk
著	着	_dzœk
盡	尽	_dzœn
燼	烬	_dzœn
嶼	屿	_dzœy
序	序	_dzœy
漵	溆	_dzœy
罪	罪	_dzœy
聚	聚	_dzœy
敘	叙	_dzœy
墜	坠	_dzœy
綴	缀	_dzœy/¯dzœy
丈	丈	_dzœŋ
像	像	_dzœŋ
象	象	_dzœŋ
仗	仗	_dzœŋ
匠	匠	_dzœŋ
杖	杖	_dzœŋ
橡	橡	_dzœŋ
滯	滞	_dzɐi
朕	朕	_dzɐm
鴆	鸩	_dzɐm
陣	阵	_dzɐn
蛭	蛭	_dzɐt
桎	桎	_dzɐt
姪	侄	_dzɐt
疾	疾	_dzɐt
蟄	蛰	_dzɐt
嫉	嫉	_dzɐt
窒	窒	_dzɐt
鷲	鹫	_dzɐu
冑	冑	_dzɐu
袖	袖	_dzɐu
就	就	_dzɐu
紂	纣	_dzɐu
宙	宙	_dzɐu
岫	岫	_dzɐu
驟	骤	_dzɐu
贈	赠	_dzɐŋ
唑	唑	_dzɔ
坐	坐	_dzɔ
座	座	_dzɔ
助	助	_dzɔ
在	在	_dzɔi
擢	擢	_dzɔk
鑿	凿	_dzɔk
臟	脏	_dzɔŋ
奘	奘	_dzɔŋ
藏	藏	_dzɔŋ
狀	状	_dzɔŋ
撞	撞	_dzɔŋ
謝	谢	_dzɛ
鄭	郑	_dzɛŋ/_dzɪŋ
淨	净	_dzɪŋ
靖	靖	_dzɪŋ
靜	静	_dzɪŋ
阱	阱	_dzɪŋ/_dzɛŋ
濁	浊	_dzʊk
續	续	_dzʊk
妯	妯	_dzʊk
鐲	镯	_dzʊk
軸	轴	_dzʊk
俗	俗	_dzʊk
鏃	镞	_dzʊk
族	族	_dzʊk
逐	逐	_dzʊk
躅	躅	_dzʊk
重	重	_dzʊŋ
頌	颂	_dzʊŋ
仲	仲	_dzʊŋ
誦	诵	_dzʊŋ
訟	讼	_dzʊŋ
盹	盹	_dœn
鈍	钝	_dœn
頓	顿	_dœn
沌	沌	_dœn
遁	遁	_dœn
噸	吨	_dœn
兌	兑	_dœy
隊	队	_dœy
第	第	_dɐi
遞	递	_dɐi
弟	弟	_dɐi
悌	悌	_dɐi
棣	棣	_dɐi
隸	隶	_dɐi
逮	逮	_dɐi/_dɔi
特	特	_dɐk
燉	炖	_dɐn
突	突	_dɐt
凸	凸	_dɐt
逗	逗	_dɐu
痘	痘	_dɐu
竇	窦	_dɐu
豆	豆	_dɐu/´dɐu
鄧	邓	_dɐŋ
瞪	瞪	_dɐŋ/'dɐŋ
墮	堕	_dɔ
馱	驮	_dɔ
惰	惰	_dɔ
岱	岱	_dɔi
玳	玳	_dɔi
待	待	_dɔi
袋	袋	_dɔi
甙	甙	_dɔi
代	代	_dɔi
黛	黛	_dɔi
靆	叇	_dɔi
殆	殆	_dɔi/ˏtɔi
怠	怠	_dɔi/ˏtɔi
踱	踱	_dɔk
鐸	铎	_dɔk
度	度	_dɔk
菪	菪	_dɔŋ
碭	砀	_dɔŋ
盪	荡	_dɔŋ
蕩	荡	_dɔŋ
宕	宕	_dɔŋ
笛	笛	_dɛk
糴	籴	_dɛk
啶	啶	_dɪŋ
定	定	_dɪŋ
毒	毒	_dʊk
碡	碡	_dʊk
獨	独	_dʊk
讀	读	_dʊk
瀆	渎	_dʊk
黷	黩	_dʊk
櫝	椟	_dʊk
牘	牍	_dʊk
髑	髑	_dʊk
犢	犊	_dʊk
侗	侗	_dʊŋ
動	动	_dʊŋ
胴	胴	_dʊŋ
慟	恸	_dʊŋ
洞	洞	_dʊŋ
恫	恫	_dʊŋ
欸	欸	_ei
范	范	_fan
犯	犯	_fan
範	范	_fan
瓣	瓣	_fan
飯	饭	_fan
駙	驸	_fu
鮒	鲋	_fu
訃	讣	_fu
父	父	_fu
輔	辅	_fu
傅	傅	_fu
付	付	_fu
腐	腐	_fu
赴	赴	_fu
負	负	_fu
仆	仆	_fu
咐	咐	_fu
附	附	_fu
吠	吠	_fɐi
份	份	_fɐn
分	分	_fɐn
筏	筏	_fɐt
佛	佛	_fɐt
罰	罚	_fɐt
閥	阀	_fɐt
伐	伐	_fɐt
乏	乏	_fɐt
阜	阜	_fɐu
宓	宓	_fʊk
茯	茯	_fʊk
伏	伏	_fʊk
袱	袱	_fʊk
復	复	_fʊk
服	服	_fʊk
鳳	凤	_fʊŋ
奉	奉	_fʊŋ
俸	俸	_fʊŋ/´fʊŋ
妓	妓	_gei
伎	伎	_gei
忌	忌	_gei
技	技	_gei
芰	芰	_gei
極	极	_gik
儉	俭	_gim
件	件	_gin
鍵	键	_gin
健	健	_gin
傑	杰	_git
桀	桀	_git
轎	轿	_giu
撬	撬	_giu
誥	诰	_gou
簣	篑	_gwɐi
跪	跪	_gwɐi
饋	馈	_gwɐi
櫃	柜	_gwɐi
珺	珺	_gwɐn
郡	郡	_gwɐn
倔	倔	_gwɐt
崛	崛	_gwɐt
掘	掘	_gwɐt
倦	倦	_gyn
鉅	巨	_gœy
苣	苣	_gœy
巨	巨	_gœy
炬	炬	_gœy
颶	飓	_gœy
懼	惧	_gœy
詎	讵	_gœy
遽	遽	_gœy
具	具	_gœy
強	强	_gœŋ
近	近	_gɐn
疙	疙	_gɐt
舊	旧	_gɐu
痙	痉	_gɪŋ
勁	劲	_gɪŋ
競	竞	_gɪŋ
局	局	_gʊk
焗	焗	_gʊk
鋦	锔	_gʊk
共	共	_gʊŋ
下	下	_ha
夏	夏	_ha
廈	厦	_ha
暇	暇	_ha
械	械	_hai
懈	懈	_hai
解	解	_hai
邂	邂	_hai/ˏhai
餡	馅	_ham
陷	陷	_ham
限	限	_han
篋	箧	_hap
峽	峡	_hap
柙	柙	_hap
狎	狎	_hap
匣	匣	_hap
俠	侠	_hap/_hɐp
狹	狭	_hap/¯hap
傚	傚	_hau
效	效	_hau
校	校	_hau
効	効	_hau
愜	惬	_hip
灝	灏	_hou
昊	昊	_hou
號	号	_hou
浩	浩	_hou
皓	皓	_hou
鎬	镐	_hou
哼	哼	_hŋ̩
繫	系	_hɐi
係	系	_hɐi
系	系	_hɐi
憾	憾	_hɐm
撼	撼	_hɐm
恨	恨	_hɐn
闔	阖	_hɐp
盒	盒	_hɐp
合	合	_hɐp
磕	磕	_hɐp
瞌	瞌	_hɐp
頜	颌	_hɐp
轄	辖	_hɐt
閡	阂	_hɐt
劾	劾	_hɐt
檄	檄	_hɐt
齕	龁	_hɐt
紇	纥	_hɐt
瞎	瞎	_hɐt
核	核	_hɐt/_wɐt
候	候	_hɐu
後	后	_hɐu
鱟	鲎	_hɐu
逅	逅	_hɐu
后	后	_hɐu
幸	幸	_hɐŋ
杏	杏	_hɐŋ
悻	悻	_hɐŋ
倖	幸	_hɐŋ
行	行	_hɐŋ
荷	荷	_hɔ
賀	贺	_hɔ
氦	氦	_hɔi
害	害	_hɔi
亥	亥	_hɔi
鶴	鹤	_hɔk
學	学	_hɔk
貉	貉	_hɔk
捍	捍	_hɔn
翰	翰	_hɔn
焊	焊	_hɔn
悍	悍	_hɔn
汗	汗	_hɔn
瀚	瀚	_hɔn
項	项	_hɔŋ
巷	巷	_hɔŋ/´hɔŋ
槲	槲	_hʊk
酷	酷	_hʊk
劓	劓	_ji
義	义	_ji
二	二	_ji
易	易	_ji
肄	肄	_ji
異	异	_ji
貳	贰	_ji
亦	亦	_jik
譯	译	_jik
繹	绎	_jik
奕	奕	_jik
驛	驿	_jik
役	役	_jik
翊	翊	_jik
液	液	_jik
弈	弈	_jik
蜴	蜴	_jik
腋	腋	_jik
疫	疫	_jik
翼	翼	_jik
翌	翌	_jik
掖	掖	_jik
弋	弋	_jik
易	易	_jik
逆	逆	_jik/_ŋak
驗	验	_jim
焰	焰	_jim
艷	艳	_jim
唁	唁	_jin
硯	砚	_jin
莧	苋	_jin
現	现	_jin
彥	彦	_jin
諺	谚	_jin
讞	谳	_jin
業	业	_jip
燁	烨	_jip
頁	页	_jip
葉	叶	_jip
熱	热	_jit
拽	拽	_jit
孽	孽	_jit
臬	臬	_jit/_nip
耀	耀	_jiu
鷂	鹞	_jiu
曜	曜	_jiu
豫	豫	_jy
語	语	_jy
裕	裕	_jy
寓	寓	_jy
御	御	_jy
與	与	_jy
譽	誉	_jy
蕷	蓣	_jy
禦	御	_jy
愈	愈	_jy
馭	驭	_jy
喻	喻	_jy
諭	谕	_jy
籲	吁	_jy
遇	遇	_jy
預	预	_jy
癒	愈	_jy
願	愿	_jyn
院	院	_jyn
縣	县	_jyn
媛	媛	_jyn
炫	炫	_jyn/ˌjyn
遠	远	_jyn/ˏjyn
悅	悦	_jyt
越	越	_jyt
粵	粤	_jyt
曰	曰	_jyt
閱	阅	_jyt
釔	钇	_jyt
穴	穴	_jyt
鉞	钺	_jyt
月	月	_jyt
乙	乙	_jyt/¯jyt
虐	虐	_jœk
鑰	钥	_jœk
藥	药	_jœk
龠	龠	_jœk
籥	籥	_jœk
弱	弱	_jœk
蒻	蒻	_jœk
瘧	疟	_jœk
若	若	_jœk
躍	跃	_jœk
謔	谑	_jœk
潤	润	_jœn
閏	闰	_jœn
芮	芮	_jœy
睿	睿	_jœy
裔	裔	_jœy
銳	锐	_jœy
恙	恙	_jœŋ
漾	漾	_jœŋ
讓	让	_jœŋ
樣	样	_jœŋ
壤	壤	_jœŋ
釀	酿	_jœŋ
曳	曳	_jɐi
跩	跩	_jɐi
賃	赁	_jɐm
衽	衽	_jɐm
妊	妊	_jɐm
飪	饪	_jɐm
任	任	_jɐm
任	任	_jɐm
胤	胤	_jɐn
紉	纫	_jɐn
釁	衅	_jɐn
刃	刃	_jɐn
孕	孕	_jɐn
韌	韧	_jɐn/_ŋɐŋ
入	入	_jɐp
軼	轶	_jɐt
溢	溢	_jɐt
逸	逸	_jɐt
日	日	_jɐt
囿	囿	_jɐu
又	又	_jɐu
宥	宥	_jɐu
釉	釉	_jɐu
侑	侑	_jɐu
佑	佑	_jɐu
右	右	_jɐu
鼬	鼬	_jɐu
狖	狖	_jɐu
夜	夜	_jɛ
偌	偌	_jɛ
認	认	_jɪŋ
育	育	_jʊk
玉	玉	_jʊk
縟	缛	_jʊk
慾	欲	_jʊk
欲	欲	_jʊk
肉	肉	_jʊk
褥	褥	_jʊk
鈺	钰	_jʊk
獄	狱	_jʊk
蓐	蓐	_jʊk
辱	辱	_jʊk
浴	浴	_jʊk
鬻	鬻	_jʊk
峪	峪	_jʊk/_jy
用	用	_jʊŋ
噱	噱	_kœk
及	及	_kɐp
芨	芨	_kɐp/'gɐp
屐	屐	_kɛk
劇	剧	_kɛk
落	落	_lai
籟	籁	_lai
賴	赖	_lai
濫	滥	_lam
艦	舰	_lam
纜	缆	_lam
爛	烂	_lan
蠟	蜡	_lap
立	立	_lap
垃	垃	_lap
砬	砬	_lap
臘	腊	_lap
邋	邋	_lap/_lat
拉	拉	_lat
辣	辣	_lat
痢	痢	_lei
吏	吏	_lei
猁	猁	_lei
利	利	_lei
莉	莉	_lei
俐	俐	_lei
蒞	莅	_lei
力	力	_lik
曆	历	_lik
歷	历	_lik
斂	敛	_lim
襝	裣	_lim
煉	炼	_lin
練	练	_lin
鬣	鬣	_lip
獵	猎	_lip
捩	捩	_lit
冽	冽	_lit
裂	裂	_lit
列	列	_lit
烈	烈	_lit
料	料	_liu
尥	尥	_liu
廖	廖	_liu
輅	辂	_lou
鷺	鹭	_lou
璐	璐	_lou
路	路	_lou
露	露	_lou
澇	涝	_lou
潞	潞	_lou
賂	赂	_lou
勞	劳	_lou
嫪	嫪	_lou
亂	乱	_lyn
掠	掠	_lœk
略	略	_lœk
吝	吝	_lœn
藺	蔺	_lœn
躪	躏	_lœn
論	论	_lœn
率	率	_lœt
律	律	_lœt
鷸	鹬	_lœt
溧	溧	_lœt
篥	篥	_lœt
傈	傈	_lœt
栗	栗	_lœt
慄	栗	_lœt
濾	滤	_lœy
類	类	_lœy
淚	泪	_lœy
慮	虑	_lœy
戾	戾	_lœy
累	累	_lœy
漯	漯	_lœy
輛	辆	_lœŋ
諒	谅	_lœŋ
踉	踉	_lœŋ
亮	亮	_lœŋ
量	量	_lœŋ
荔	荔	_lɐi
礪	砺	_lɐi
蠣	蛎	_lɐi
麗	丽	_lɐi
厲	厉	_lɐi
儷	俪	_lɐi
勵	励	_lɐi
例	例	_lɐi
肋	肋	_lɐk/_lak
鰳	鳓	_lɐk/_lak
勒	勒	_lɐk/_lak
陋	陋	_lɐu
蹓	蹓	_lɐu
鏤	镂	_lɐu
遛	遛	_lɐu
餾	馏	_lɐu
漏	漏	_lɐu
溜	溜	_lɐu
睞	睐	_lɔi
賚	赉	_lɔi
耒	耒	_lɔi/_lœy
樂	乐	_lɔk
落	落	_lɔk
蒗	蒗	_lɔŋ
晾	晾	_lɔŋ
浪	浪	_lɔŋ
閬	阆	_lɔŋ/ˌlɔŋ
令	令	_lɪŋ
另	另	_lɪŋ
愣	愣	_lɪŋ
陸	陆	_lʊk
鹿	鹿	_lʊk
漉	漉	_lʊk
碌	碌	_lʊk
戮	戮	_lʊk
祿	禄	_lʊk
氯	氯	_lʊk
錄	录	_lʊk
綠	绿	_lʊk
六	六	_lʊk
弄	弄	_lʊŋ
罵	骂	_ma
邁	迈	_mai
賣	卖	_mai
鏝	镘	_man
謾	谩	_man
嫚	嫚	_man
萬	万	_man
慢	慢	_man
蔓	蔓	_man
縵	缦	_man
曼	曼	_man
熳	熳	_man
漫	漫	_man
幔	幔	_man
墁	墁	_man
懋	懋	_mau
貌	貌	_mau
袤	袤	_mau
孟	孟	_maŋ
味	味	_mei
寐	寐	_mei
媚	媚	_mei
魅	魅	_mei
未	未	_mei
覓	觅	_mik
汨	汨	_mik
冪	幂	_mik
鼏	鼏	_mik
面	面	_min
麵	面	_min
衊	蔑	_mit
滅	灭	_mit
蔑	蔑	_mit
篾	篾	_mit
廟	庙	_miu
妙	妙	_miu
霧	雾	_mou
務	务	_mou
帽	帽	_mou
慕	慕	_mou
募	募	_mou
墓	墓	_mou
瑁	瑁	_mou
戊	戊	_mou
婺	婺	_mou
暮	暮	_mou
鶩	鹜	_mou
耄	耄	_mou
騖	骛	_mou
冒	冒	_mou
昧	昧	_mui
妹	妹	_mui
悶	闷	_mun
燜	焖	_mun
歿	殁	_mut
末	末	_mut
沒	没	_mut
靺	靺	_mut
茉	茉	_mut
袂	袂	_mɐi
陌	陌	_mɐk
万	万	_mɐk
墨	墨	_mɐk
默	默	_mɐk
貘	貘	_mɐk
驀	蓦	_mɐk
麥	麦	_mɐk
脈	脉	_mɐk
汶	汶	_mɐn
紊	紊	_mɐn
問	问	_mɐn
宓	宓	_mɐt
嘧	嘧	_mɐt
密	密	_mɐt
勿	勿	_mɐt
蜜	蜜	_mɐt
物	物	_mɐt
襪	袜	_mɐt
謐	谧	_mɐt
貿	贸	_mɐu
謬	谬	_mɐu
茂	茂	_mɐu
漠	漠	_mɔk
寞	寞	_mɔk
莫	莫	_mɔk
膜	膜	_mɔk
幕	幕	_mɔk
望	望	_mɔŋ
命	命	_mɛŋ
命	命	_mɪŋ
沐	沐	_mʊk
睦	睦	_mʊk
牧	牧	_mʊk
穆	穆	_mʊk
仫	仫	_mʊk
木	木	_mʊk
鉬	钼	_mʊk
目	目	_mʊk
苜	苜	_mʊk
夢	梦	_mʊŋ
難	难	_nan
鈉	钠	_nap
納	纳	_nap
衲	衲	_nap
吶	呐	_nap
捺	捺	_nat
淖	淖	_nau
鬧	闹	_nau
膩	腻	_nei
餌	饵	_nei
廿	廿	_nim
念	念	_nim
唸	念	_nim
鑷	镊	_nip
涅	涅	_nip
顳	颞	_nip
躡	蹑	_nip
捏	捏	_nip
隉	陧	_nip
聶	聂	_nip
尿	尿	_niu
溺	溺	_niu
怒	怒	_nou
嫩	嫩	_nyn
訥	讷	_nœt/_nap
懦	懦	_nɔ
糯	糯	_nɔ
奈	奈	_nɔi
內	内	_nɔi
耐	耐	_nɔi
諾	诺	_nɔk
齉	齉	_nɔŋ
佞	佞	_nɪŋ
濘	泞	_nɪŋ
擰	拧	_nɪŋ
忸	忸	_nʊk/´nɐu
伺	伺	_si
視	视	_si
是	是	_si
侍	侍	_si
士	士	_si
事	事	_si
示	示	_si
仕	仕	_si
豉	豉	_si
氏	氏	_si
蝕	蚀	_sik
食	食	_sik
贍	赡	_sim
撣	掸	_sin
善	善	_sin
禪	禅	_sin
鄯	鄯	_sin
單	单	_sin
嬗	嬗	_sin
羨	羡	_sin
擅	擅	_sin
繕	缮	_sin
倩	倩	_sin
膳	膳	_sin
茜	茜	_sin/'sɐi
紹	绍	_siu
肇	肇	_siu
劭	劭	_siu
邵	邵	_siu
兆	兆	_siu
樹	树	_sy
豎	竖	_sy
篆	篆	_syn
順	顺	_sœn
沭	沭	_sœt
述	述	_sœt
術	术	_sœt
粹	粹	_sœy
祟	祟	_sœy
悴	悴	_sœy
遂	遂	_sœy
睡	睡	_sœy
燧	燧	_sœy
邃	邃	_sœy
萃	萃	_sœy
穗	穗	_sœy
瑞	瑞	_sœy
隧	隧	_sœy
瘁	瘁	_sœy/ˏsœy
尚	尚	_sœŋ
上	上	_sœŋ
誓	誓	_sɐi
噬	噬	_sɐi
逝	逝	_sɐi
筮	筮	_sɐi
椹	葚	_sɐm
什	什	_sɐm
甚	甚	_sɐm
慎	慎	_sɐn
蜃	蜃	_sɐn/ˏsɐn
拾	拾	_sɐp
十	十	_sɐp
實	实	_sɐt
綬	绶	_sɐu
授	授	_sɐu
受	受	_sɐu
壽	寿	_sɐu
售	售	_sɐu
射	射	_sɛ
麝	麝	_sɛ
碩	硕	_sɛk
石	石	_sɛk
盛	盛	_sɪŋ
剩	剩	_sɪŋ
嵊	嵊	_sɪŋ
贖	赎	_sʊk
淑	淑	_sʊk
屬	属	_sʊk
塾	塾	_sʊk
孰	孰	_sʊk
蜀	蜀	_sʊk
熟	熟	_sʊk
菽	菽	_sʊk
鰂	鲗	_tsak
賊	贼	_tsak
鋥	锃	_tsaŋ
華	华	_wa
話	话	_wa
樺	桦	_wa/ˌwa
壞	坏	_wai
惑	惑	_wak
劃	划	_wak
畫	画	_wak
或	或	_wak
幻	幻	_wan
宦	宦	_wan
患	患	_wan
滑	滑	_wat
猾	猾	_wat
橫	横	_waŋ
蜮	蜮	_wik
閾	阈	_wik
域	域	_wik
扈	扈	_wu
芋	芋	_wu
互	互	_wu
戶	户	_wu
滬	沪	_wu
護	护	_wu
怙	怙	_wu
祜	祜	_wu
瓠	瓠	_wu/ˌwu
會	会	_wui
匯	汇	_wui
燴	烩	_wui
彙	汇	_wui/_wɐi
會	会	_wui/´wui
奐	奂	_wun
緩	缓	_wun
玩	玩	_wun
煥	焕	_wun
換	换	_wun
喚	唤	_wun
瘓	痪	_wun
活	活	_wut
彗	彗	_wɐi
慧	慧	_wɐi
衛	卫	_wɐi
為	为	_wɐi
蝟	猬	_wɐi
胃	胃	_wɐi
渭	渭	_wɐi
蕙	蕙	_wɐi
謂	谓	_wɐi
惠	惠	_wɐi
位	位	_wɐi
混	混	_wɐn
運	运	_wɐn
諢	诨	_wɐn
鄆	郓	_wɐn
暈	晕	_wɐn
熨	熨	_wɐn
韻	韵	_wɐn/ˏwɐn
鷸	鹬	_wɐt
聿	聿	_wɐt/_lœt
禍	祸	_wɔ
穫	获	_wɔk
鑊	镬	_wɔk
獲	获	_wɔk
旺	旺	_wɔŋ
潁	颍	_wɪŋ
穎	颖	_wɪŋ
泳	泳	_wɪŋ
詠	咏	_wɪŋ
訝	讶	_ŋa
刈	刈	_ŋai
艾	艾	_ŋai
砹	砹	_ŋai
額	额	_ŋak
雁	雁	_ŋan
贗	赝	_ŋan
硬	硬	_ŋaŋ
齧	啮	_ŋit/_ŋat
傲	傲	_ŋou
藝	艺	_ŋɐi
囈	呓	_ŋɐi
睨	睨	_ŋɐi
毅	毅	_ŋɐi
偽	伪	_ŋɐi
魏	魏	_ŋɐi
羿	羿	_ŋɐi
詣	诣	_ŋɐi
兀	兀	_ŋɐt
屹	屹	_ŋɐt
杌	杌	_ŋɐt
圪	圪	_ŋɐt
迄	迄	_ŋɐt
臥	卧	_ŋɔ
餓	饿	_ŋɔ
外	外	_ŋɔi
礙	碍	_ŋɔi
噩	噩	_ŋɔk
顎	颚	_ŋɔk
岳	岳	_ŋɔk
樂	乐	_ŋɔk
鱷	鳄	_ŋɔk
鄂	鄂	_ŋɔk
嶽	岳	_ŋɔk
愕	愕	_ŋɔk
犴	犴	_ŋɔn
岸	岸	_ŋɔn
摀	捂	_ŋ̩
悟	悟	_ŋ̩
焐	焐	_ŋ̩
嗯	嗯	_ŋ̩
誤	误	_ŋ̩
晤	晤	_ŋ̩
哦	哦	_ɔ
氬	氩	¯a
亞	亚	¯a
啊	啊	¯a
阿	阿	¯a
婭	娅	¯a
隘	隘	¯ai
晏	晏	¯an
鴨	鸭	¯ap
押	押	¯at
遏	遏	¯at
壓	压	¯at
軋	轧	¯at
猰	猰	¯at
揠	揠	¯at
拗	拗	¯au
坳	坳	¯au/'au
霸	霸	¯ba
壩	坝	¯ba
拜	拜	¯bai
伯	伯	¯bak
百	百	¯bak
佰	佰	¯bak
扮	扮	¯ban
八	八	¯bat
捌	捌	¯bat
爆	爆	¯bau
臂	臂	¯bei
痺	痹	¯bei
秘	秘	¯bei
轡	辔	¯bei
泌	泌	¯bei
鉍	铋	¯bei
庇	庇	¯bei
變	变	¯bin
彆	别	¯bit
鱉	鳖	¯bit
憋	憋	¯bit
埔	埔	¯bou
布	布	¯bou
怖	怖	¯bou
報	报	¯bou
佈	布	¯bou
揹	背	¯bui
狽	狈	¯bui
輩	辈	¯bui
鋇	钡	¯bui
貝	贝	¯bui
半	半	¯bun
缽	钵	¯but
贔	赑	¯bɐi
蔽	蔽	¯bɐi
閉	闭	¯bɐi
擯	摈	¯bɐn
鬢	鬓	¯bɐn
殯	殡	¯bɐn
播	播	¯bɔ
簸	簸	¯bɔ
亳	亳	¯bɔk
膊	膊	¯bɔk
駁	驳	¯bɔk
博	博	¯bɔk
搏	搏	¯bɔk
縛	缚	¯bɔk/¯fɔk
柄	柄	¯bɛŋ/¯bɪŋ
迸	迸	¯bɪŋ
併	并	¯bɪŋ/¯pɪŋ
甭	甭	¯bʊŋ
帶	带	¯dai
戴	戴	¯dai
誕	诞	¯dan
旦	旦	¯dan
耷	耷	¯dap
搭	搭	¯dap
答	答	¯dap
瘩	瘩	¯dap
靼	靼	¯dat
妲	妲	¯dat/´tan
店	店	¯dim
踮	踮	¯dim
玷	玷	¯dim
惦	惦	¯dim
墊	垫	¯din
跌	跌	¯dit
吊	吊	¯diu
弔	吊	¯diu
釣	钓	¯diu
到	到	¯dou
妒	妒	¯dou
倒	倒	¯dou
蠹	蠹	¯dou
鍛	锻	¯dyn
煅	煅	¯dyn
詐	诈	¯dza
咤	咤	¯dza
榨	榨	¯dza
咋	咋	¯dza
乍	乍	¯dza
炸	炸	¯dza
蚱	蚱	¯dza/¯dzak
債	债	¯dzai
責	责	¯dzak
嘖	啧	¯dzak
窄	窄	¯dzak
湛	湛	¯dzam
蘸	蘸	¯dzam
贊	赞	¯dzan
讚	赞	¯dzan
咂	咂	¯dzap
匝	匝	¯dzap
砸	砸	¯dzap
眨	眨	¯dzap
扎	扎	¯dzat
軋	轧	¯dzat
鍘	铡	¯dzat
札	札	¯dzat
拶	拶	¯dzat
紮	紮	¯dzat
罩	罩	¯dzau
置	置	¯dzi
致	致	¯dzi
緻	致	¯dzi
誌	志	¯dzi
輊	轾	¯dzi
志	志	¯dzi
摯	挚	¯dzi
智	智	¯dzi
痣	痣	¯dzi
躓	踬	¯dzi
質	质	¯dzi
至	至	¯dzi
恣	恣	¯dzi/¯tsi
瘠	瘠	¯dzik
脊	脊	¯dzik/¯dzɛk
炙	炙	¯dzik/¯dzɛk
佔	占	¯dzim
餞	饯	¯dzin
戰	战	¯dzin
顫	颤	¯dzin
箭	箭	¯dzin
薦	荐	¯dzin
濺	溅	¯dzin
接	接	¯dzip
輒	辄	¯dzip
浹	浃	¯dzip
囁	嗫	¯dzip
摺	折	¯dzip
褶	褶	¯dzip
楫	楫	¯dzip
哲	哲	¯dzit
櫛	栉	¯dzit
蜇	蜇	¯dzit
婕	婕	¯dzit
折	折	¯dzit
浙	浙	¯dzit
節	节	¯dzit
癤	疖	¯dzit
照	照	¯dziu
詔	诏	¯dziu
灶	灶	¯dzou
注	注	¯dzy
炷	炷	¯dzy
駐	驻	¯dzy
著	著	¯dzy
註	注	¯dzy
著	著	¯dzy
蛀	蛀	¯dzy
鑽	钻	¯dzyn
轉	转	¯dzyn
鑽	钻	¯dzyn/'dzyn
拙	拙	¯dzyt
啜	啜	¯dzyt
掇	掇	¯dzyt
茁	茁	¯dzyt
輟	辍	¯dzyt
咄	咄	¯dzyt
嚼	嚼	¯dzœk
著	着	¯dzœk
灼	灼	¯dzœk
雀	雀	¯dzœk
鵲	鹊	¯dzœk
斫	斫	¯dzœk
酌	酌	¯dzœk
爵	爵	¯dzœk
桌	桌	¯dzœk/¯tsœk
勺	勺	¯dzœk/¯tsœk
俊	俊	¯dzœn
進	进	¯dzœn
竣	竣	¯dzœn
晉	晋	¯dzœn
縉	缙	¯dzœn
峻	峻	¯dzœn
駿	骏	¯dzœn
惴	惴	¯dzœy
贅	赘	¯dzœy
最	最	¯dzœy
醉	醉	¯dzœy
障	障	¯dzœŋ
仗	仗	¯dzœŋ
帳	帐	¯dzœŋ
瘴	瘴	¯dzœŋ
嶂	嶂	¯dzœŋ
將	将	¯dzœŋ
賬	账	¯dzœŋ
醬	酱	¯dzœŋ
漲	涨	¯dzœŋ
幛	幛	¯dzœŋ
脹	胀	¯dzœŋ
祭	祭	¯dzɐi
霽	霁	¯dzɐi
製	制	¯dzɐi
制	制	¯dzɐi
掣	掣	¯dzɐi
際	际	¯dzɐi
濟	济	¯dzɐi
枕	枕	¯dzɐm
浸	浸	¯dzɐm
震	震	¯dzɐn
圳	圳	¯dzɐn
賑	赈	¯dzɐn
振	振	¯dzɐn
鎮	镇	¯dzɐn
晝	昼	¯dzɐu
奏	奏	¯dzɐu
皺	皱	¯dzɐu
咒	咒	¯dzɐu
揍	揍	¯dzɐu
縐	绉	¯dzɐu
佐	佐	¯dzɔ
詛	诅	¯dzɔ/´dzɔ
載	载	¯dzɔi
再	再	¯dzɔi
作	作	¯dzɔk
昨	昨	¯dzɔk/_dzɔk
壯	壮	¯dzɔŋ
葬	葬	¯dzɔŋ
戇	戆	¯dzɔŋ/_ŋɔŋ
蔗	蔗	¯dzɛ
柘	柘	¯dzɛ
借	借	¯dzɛ
隻	只	¯dzɛk
證	证	¯dzɪŋ
症	症	¯dzɪŋ
政	政	¯dzɪŋ
正	正	¯dzɪŋ
縱	纵	¯dzʊŋ
中	中	¯dzʊŋ
種	种	¯dzʊŋ
眾	众	¯dzʊŋ
粽	粽	¯dzʊŋ/´dzʊŋ
斲	斫	¯dœk
琢	琢	¯dœk
啄	啄	¯dœk
涿	涿	¯dœk
對	对	¯dœy
碲	碲	¯dɐi
帝	帝	¯dɐi
諦	谛	¯dɐi
締	缔	¯dɐi
蒂	蒂	¯dɐi
鬥	斗	¯dɐu
磴	磴	¯dɐŋ
鐙	镫	¯dɐŋ
凳	凳	¯dɐŋ
當	当	¯dɔŋ
檔	档	¯dɔŋ
碇	碇	¯dɪŋ
錠	锭	¯dɪŋ/_dɪŋ
訂	订	¯dɪŋ/_dɪŋ
凍	冻	¯dʊŋ
棟	栋	¯dʊŋ
化	化	¯fa
塊	块	¯fai
傀	傀	¯fai
筷	筷	¯fai
快	快	¯fai
噲	哙	¯fai
泛	泛	¯fan/_fan
販	贩	¯fan/´fan
法	法	¯fat
琺	珐	¯fat
髮	发	¯fat
發	发	¯fat
褲	裤	¯fu
賦	赋	¯fu
富	富	¯fu
戽	戽	¯fu
庫	库	¯fu
絝	绔	¯fu
副	副	¯fu
晦	晦	¯fui
悔	悔	¯fui
誨	诲	¯fui
闊	阔	¯fut
肺	肺	¯fɐi
沸	沸	¯fɐi
廢	废	¯fɐi
費	费	¯fɐi
狒	狒	¯fɐi
訓	训	¯fɐn
糞	粪	¯fɐn
貨	货	¯fɔ
課	课	¯fɔ
霍	霍	¯fɔk
攫	攫	¯fɔk
況	况	¯fɔŋ
放	放	¯fɔŋ
諷	讽	¯fʊŋ
稼	稼	¯ga
嫁	嫁	¯ga
價	价	¯ga
咖	咖	¯ga
假	假	¯ga
架	架	¯ga
駕	驾	¯ga
誡	诫	¯gai
疥	疥	¯gai
芥	芥	¯gai
戒	戒	¯gai
界	界	¯gai
尬	尬	¯gai
屆	届	¯gai
介	介	¯gai
解	解	¯gai
嗝	嗝	¯gak
骼	骼	¯gak
膈	膈	¯gak
鎘	镉	¯gak
隔	隔	¯gak
革	革	¯gak
格	格	¯gak
胳	胳	¯gak
監	监	¯gam
鑑	鉴	¯gam
諫	谏	¯gan
澗	涧	¯gan
間	间	¯gan
胛	胛	¯gap
蛺	蛱	¯gap
鉀	钾	¯gap
頰	颊	¯gap
甲	甲	¯gap
餄	饸	¯gap
莢	荚	¯gap
夾	夹	¯gap
郟	郏	¯gap
岬	岬	¯gap
袷	袷	¯gap
軋	轧	¯gat
窖	窖	¯gau
較	较	¯gau
鉸	铰	¯gau
覺	觉	¯gau
教	教	¯gau
校	校	¯gau
酵	酵	¯gau/'hau
紀	纪	¯gei
覬	觊	¯gei
記	记	¯gei
寄	寄	¯gei
既	既	¯gei
劍	剑	¯gim
腱	腱	¯gin
見	见	¯gin
建	建	¯gin
劫	劫	¯gip
拮	拮	¯git
潔	洁	¯git
結	结	¯git
叫	叫	¯giu
郜	郜	¯gou
告	告	¯gou
鋯	锆	¯gou
故	故	¯gu
錮	锢	¯gu
顧	顾	¯gu
僱	雇	¯gu
固	固	¯gu
罐	罐	¯gun
盥	盥	¯gun
鸛	鹳	¯gun
貫	贯	¯gun
冠	冠	¯gun
灌	灌	¯gun
褂	褂	¯gwa
掛	挂	¯gwa
卦	卦	¯gwa
怪	怪	¯gwai
摑	掴	¯gwak
慣	惯	¯gwan
摜	掼	¯gwan
颳	刮	¯gwat
刮	刮	¯gwat
季	季	¯gwɐi
瑰	瑰	¯gwɐi
癸	癸	¯gwɐi
悸	悸	¯gwɐi
桂	桂	¯gwɐi
貴	贵	¯gwɐi
棍	棍	¯gwɐn
過	过	¯gwɔ
幗	帼	¯gwɔk
郭	郭	¯gwɔk
膕	腘	¯gwɔk
國	国	¯gwɔk
廓	廓	¯gwɔk/¯kwɔk
桄	桄	¯gwɔŋ
絹	绢	¯gyn
券	券	¯gyn
眷	眷	¯gyn
鄄	鄄	¯gyn
腳	脚	¯gœk
句	句	¯gœy
據	据	¯gœy
踞	踞	¯gœy
鋸	锯	¯gœy/¯gɛu
計	计	¯gɐi
髻	髻	¯gɐi
繼	继	¯gɐi
薊	蓟	¯gɐi
淦	淦	¯gɐm
贛	赣	¯gɐm
禁	禁	¯gɐm
噤	噤	¯gɐm
靳	靳	¯gɐn
艮	艮	¯gɐn
覲	觐	¯gɐn/´gɐn
鴿	鸽	¯gɐp
蛤	蛤	¯gɐp
嘎	嘎	¯gɐt
灸	灸	¯gɐu
垢	垢	¯gɐu
夠	够	¯gɐu
詬	诟	¯gɐu
救	救	¯gɐu
疚	疚	¯gɐu
究	究	¯gɐu
柩	柩	¯gɐu
廄	厩	¯gɐu
咎	咎	¯gɐu
更	更	¯gɐŋ
個	个	¯gɔ
蓋	盖	¯gɔi
各	各	¯gɔk
覺	觉	¯gɔk
擱	搁	¯gɔk
閣	阁	¯gɔk
角	角	¯gɔk
幹	干	¯gɔn
葛	葛	¯gɔt
割	割	¯gɔt
絳	绛	¯gɔŋ
鋼	钢	¯gɔŋ
槓	杠	¯gɔŋ
降	降	¯gɔŋ
鏡	镜	¯gɛŋ
徑	径	¯gɪŋ
逕	径	¯gɪŋ
敬	敬	¯gɪŋ
勁	劲	¯gɪŋ
供	供	¯gʊŋ
貢	贡	¯gʊŋ
嚇	吓	¯hak
客	客	¯hak
喊	喊	¯ham
嗑	嗑	¯hap
掐	掐	¯hap
呷	呷	¯hap
孝	孝	¯hau
器	器	¯hei
汽	汽	¯hei
戲	戏	¯hei
氣	气	¯hei
棄	弃	¯hei
憩	憩	¯hei
欠	欠	¯him
芡	芡	¯him
憲	宪	¯hin
獻	献	¯hin
歉	歉	¯hip
協	协	¯hip
怯	怯	¯hip
脅	胁	¯hip
挾	挟	¯hip/_hap
蠍	蝎	¯hit
歇	歇	¯hit
竅	窍	¯hiu/¯kiu
犒	犒	¯hou
耗	耗	¯hou
好	好	¯hou
勸	劝	¯hyn
券	券	¯hyn
綣	绻	¯hyn
絢	绚	¯hyn
血	血	¯hyt
去	去	¯hœy
嚮	向	¯hœŋ
向	向	¯hœŋ
磡	磡	¯hɐm
瞰	瞰	¯hɐm
崁	崁	¯hɐm
勘	勘	¯hɐm
嵌	嵌	¯hɐm/_hɐm
吼	吼	¯hɐu
殼	壳	¯hɔk
漢	汉	¯hɔn
看	看	¯hɔn
喝	喝	¯hɔt
褐	褐	¯hɔt
渴	渴	¯hɔt
鞨	鞨	¯hɔt
吃	吃	¯hɛk
磬	磬	¯hɪŋ
慶	庆	¯hɪŋ
罄	罄	¯hɪŋ
興	兴	¯hɪŋ
控	控	¯hʊŋ
汞	汞	¯hʊŋ
哄	哄	¯hʊŋ
烘	烘	¯hʊŋ/'hʊŋ
鬨	哄	¯hʊŋ/_hʊŋ
鐿	镱	¯ji
意	意	¯ji
懿	懿	¯ji
薏	薏	¯ji
癔	癔	¯ji
厭	厌	¯jim
饜	餍	¯jim
燕	燕	¯jin
嚥	咽	¯jin
宴	宴	¯jin
靨	靥	¯jip
咽	咽	¯jit
噎	噎	¯jit
謁	谒	¯jit
要	要	¯jiu
酗	酗	¯jy/´hœy/¯hœy
怨	怨	¯jyn
約	约	¯jœk
蔭	荫	¯jɐm
窨	窨	¯jɐm
印	印	¯jɐn
幼	幼	¯jɐu
應	应	¯jɪŋ
髂	髂	¯ka
揢	揢	¯kak
咯	咯	¯kak
靠	靠	¯kau
銬	铐	¯kau
冀	冀	¯kei
暨	暨	¯kei
驥	骥	¯kei
孑	孑	¯kit
頡	颉	¯kit
黠	黠	¯kit
揭	揭	¯kit
鍥	锲	¯kit
竭	竭	¯kit
羯	羯	¯kit
詰	诘	¯kit
擷	撷	¯kit/¯git
翹	翘	¯kiu/¯hiu
聒	聒	¯kut
蛞	蛞	¯kut
豁	豁	¯kut
括	括	¯kut
挎	挎	¯kwa
跨	跨	¯kwa
胯	胯	¯kwa
逛	逛	¯kwaŋ
困	困	¯kwɐn
睏	困	¯kwɐn
窘	窘	¯kwɐn
擴	扩	¯kwɔk
曠	旷	¯kwɔŋ
鄺	邝	¯kwɔŋ/¯kɔŋ
礦	矿	¯kwɔŋ/¯kɔŋ
撅	撅	¯kyt
厥	厥	¯kyt
蕨	蕨	¯kyt
闕	阙	¯kyt
缺	缺	¯kyt
決	决	¯kyt
蹶	蹶	¯kyt
孓	孓	¯kyt
抉	抉	¯kyt
訣	诀	¯kyt
獗	獗	¯kyt
橛	橛	¯kyt/_gyt
卻	却	¯kœk
契	契	¯kɐi
叩	叩	¯kɐu
寇	寇	¯kɐu
蔻	蔻	¯kɐu
釦	扣	¯kɐu
扣	扣	¯kɐu
購	购	¯kɐu/¯gɐu
構	构	¯kɐu/¯gɐu
媾	媾	¯kɐu/¯gɐu
欬	欬	¯kɔi
愾	忾	¯kɔi
丐	丐	¯kɔi
概	概	¯kɔi
蓋	盖	¯kɔi
溉	溉	¯kɔi
慨	慨	¯kɔi
鈣	钙	¯kɔi
恪	恪	¯kɔk
郝	郝	¯kɔk
慤	悫	¯kɔk
壑	壑	¯kɔk
涸	涸	¯kɔk
確	确	¯kɔk
榷	榷	¯kɔk
閌	闶	¯kɔŋ
炕	炕	¯kɔŋ
擴	扩	¯kɔŋ
伉	伉	¯kɔŋ
抗	抗	¯kɔŋ
亢	亢	¯kɔŋ
喇	喇	¯la
癩	癞	¯lai
捋	捋	¯lyt
劣	劣	¯lyt/_lyt
珞	珞	¯lɔk
酪	酪	¯lɔk
餎	饹	¯lɔk
鉻	铬	¯lɔk
絡	络	¯lɔk
烙	烙	¯lɔk
洛	洛	¯lɔk/_lɔk
駱	骆	¯lɔk/_lɔk
靚	靓	¯lɛŋ
嘛	嘛	¯ma
擘	擘	¯mak
沫	沫	¯mut
抹	抹	¯mut/¯mat
怕	怕	¯pa
派	派	¯pai
哌	哌	¯pai
湃	湃	¯pai/¯bai
魄	魄	¯pak
帕	帕	¯pak
柏	柏	¯pak
拍	拍	¯pak
珀	珀	¯pak
袢	袢	¯pan
盼	盼	¯pan
泡	泡	¯pau
疱	疱	¯pau
豹	豹	¯pau
炮	炮	¯pau
譬	譬	¯pei
濞	濞	¯pei
屁	屁	¯pei
媲	媲	¯pei/´bei
片	片	¯pin
遍	遍	¯pin
騙	骗	¯pin
瞥	瞥	¯pit
撇	撇	¯pit
漂	漂	¯piu
票	票	¯piu
剽	剽	¯piu/ˏpiu
舖	铺	¯pou
沛	沛	¯pui
佩	佩	¯pui
霈	霈	¯pui
配	配	¯pui
珮	珮	¯pui
判	判	¯pun
拚	拚	¯pun
潑	泼	¯put
噴	喷	¯pɐn
破	破	¯pɔ
璞	璞	¯pɔk
噗	噗	¯pɔk
撲	扑	¯pɔk
樸	朴	¯pɔk
釙	钋	¯pɔk
粕	粕	¯pɔk/¯pak
謗	谤	¯pɔŋ
劈	劈	¯pɛk
聘	聘	¯pɪŋ
碰	碰	¯pʊŋ
曬	晒	¯sai
索	索	¯sak/¯sɔk
三	三	¯sam
訕	讪	¯san
篡	篡	¯san
散	散	¯san
傘	伞	¯san
涮	涮	¯san
疝	疝	¯san
汕	汕	¯san
颯	飒	¯sap
圾	圾	¯sap
鎩	铩	¯sat
薩	萨	¯sat
撒	撒	¯sat
剎	刹	¯sat
殺	杀	¯sat
煞	煞	¯sat
哨	哨	¯sau
四	四	¯sei
使	使	¯si
泗	泗	¯si
弒	弑	¯si
試	试	¯si
嗜	嗜	¯si
諡	谥	¯si
駟	驷	¯si
肆	肆	¯si
腺	腺	¯sin
扇	扇	¯sin
煽	煽	¯sin
霰	霰	¯sin
線	线	¯sin
騸	骟	¯sin
攝	摄	¯sip
涉	涉	¯sip
歙	歙	¯sip
懾	慑	¯sip/¯dzip
屑	屑	¯sit
竊	窃	¯sit
絏	绁	¯sit
褻	亵	¯sit
舌	舌	¯sit
洩	泄	¯sit
楔	楔	¯sit
薛	薛	¯sit
揳	揳	¯sit/¯sip
嘯	啸	¯siu
笑	笑	¯siu
少	少	¯siu
數	数	¯sou
溯	溯	¯sou
素	素	¯sou
掃	扫	¯sou
臊	臊	¯sou
塑	塑	¯sou
訴	诉	¯sou
愫	愫	¯sou
庶	庶	¯sy
恕	恕	¯sy
戍	戍	¯sy
蒜	蒜	¯syn
算	算	¯syn
渲	渲	¯syn/'hyn
雪	雪	¯syt
鱈	鳕	¯syt
說	说	¯syt
爍	烁	¯sœk
鑠	铄	¯sœk
削	削	¯sœk
舜	舜	¯sœn
瞬	瞬	¯sœn
遜	逊	¯sœn
汛	汛	¯sœn
信	信	¯sœn
浚	浚	¯sœn
巽	巽	¯sœn
訊	讯	¯sœn
迅	迅	¯sœn
囟	囟	¯sœn/´sœn
稅	税	¯sœy
說	说	¯sœy
碎	碎	¯sœy
帥	帅	¯sœy
歲	岁	¯sœy
相	相	¯sœŋ
世	世	¯sɐi
勢	势	¯sɐi
細	细	¯sɐi
婿	婿	¯sɐi
沁	沁	¯sɐm
滲	渗	¯sɐm
霎	霎	¯sɐp
秀	秀	¯sɐu
嗽	嗽	¯sɐu
鏽	锈	¯sɐu
獸	兽	¯sɐu
瘦	瘦	¯sɐu
狩	狩	¯sɐu
琇	琇	¯sɐu
繡	绣	¯sɐu
宿	宿	¯sɐu
漱	漱	¯sɐu
蹭	蹭	¯sɐŋ
擤	擤	¯sɐŋ
朔	朔	¯sɔk
說	说	¯sɔk
索	索	¯sɔk
喪	丧	¯sɔŋ
猞	猞	¯sɛ
卸	卸	¯sɛ
赦	赦	¯sɛ
瀉	泻	¯sɛ
舍	舍	¯sɛ
錫	锡	¯sɛk
聖	圣	¯sɪŋ
性	性	¯sɪŋ
姓	姓	¯sɪŋ
勝	胜	¯sɪŋ
宋	宋	¯sʊŋ
送	送	¯sʊŋ
態	态	¯tai
肽	肽	¯tai
泰	泰	¯tai
太	太	¯tai
貸	贷	¯tai
汰	汰	¯tai
鈦	钛	¯tai
傣	傣	¯tai
探	探	¯tam
罈	坛	¯tam
碳	碳	¯tan
歎	叹	¯tan
炭	炭	¯tan
塔	塔	¯tap
榻	榻	¯tap
塌	塌	¯tap
漯	漯	¯tap
遢	遢	¯tap/¯tat
韃	鞑	¯tat
趿	趿	¯tat
撻	挞	¯tat
躂	跶	¯tat
闥	闼	¯tat
帖	帖	¯tip
貼	贴	¯tip
萜	萜	¯tip
鐵	铁	¯tit
餮	餮	¯tit
眺	眺	¯tiu
跳	跳	¯tiu
兔	兔	¯tou
套	套	¯tou
吐	吐	¯tou
姹	姹	¯tsa
衩	衩	¯tsa
詫	诧	¯tsa
杈	杈	¯tsa
岔	岔	¯tsa
蠆	虿	¯tsai
策	策	¯tsak
柵	栅	¯tsak
冊	册	¯tsak
拆	拆	¯tsak
懺	忏	¯tsam
杉	杉	¯tsam/'sam
燦	灿	¯tsan
璨	璨	¯tsan
插	插	¯tsap
鍤	锸	¯tsap
察	察	¯tsat
刷	刷	¯tsat
獺	獭	¯tsat
擦	擦	¯tsat
剎	刹	¯tsat/¯sat
肏	肏	¯tsau
次	次	¯tsi
幟	帜	¯tsi
刺	刺	¯tsi
翅	翅	¯tsi
廁	厕	¯tsi
賜	赐	¯tsi
熾	炽	¯tsi
塹	堑	¯tsim
僭	僭	¯tsim
暹	暹	¯tsim/'tsim
妾	妾	¯tsip
澈	澈	¯tsit
轍	辙	¯tsit
設	设	¯tsit
切	切	¯tsit
撤	撤	¯tsit
掣	掣	¯tsit
徹	彻	¯tsit
俏	俏	¯tsiu
肖	肖	¯tsiu
鞘	鞘	¯tsiu
峭	峭	¯tsiu
醋	醋	¯tsou
措	措	¯tsou
糙	糙	¯tsou
燥	燥	¯tsou
噪	噪	¯tsou
躁	躁	¯tsou
操	操	¯tsou/'tsou
處	处	¯tsy
串	串	¯tsyn
寸	寸	¯tsyn
爨	爨	¯tsyn
竄	窜	¯tsyn
吋	吋	¯tsyn
撮	撮	¯tsyt
猝	猝	¯tsyt
踅	踅	¯tsyt
綽	绰	¯tsœk
卓	卓	¯tsœk
戳	戳	¯tsœk
脆	脆	¯tsœy
趣	趣	¯tsœy
翠	翠	¯tsœy
啐	啐	¯tsœy
覷	觑	¯tsœy
淬	淬	¯tsœy/_sœy
焠	焠	¯tsœy/_sœy
嗆	呛	¯tsœŋ
戧	戗	¯tsœŋ
唱	唱	¯tsœŋ
悵	怅	¯tsœŋ
蹌	跄	¯tsœŋ
熗	炝	¯tsœŋ
暢	畅	¯tsœŋ
倡	倡	¯tsœŋ
切	切	¯tsɐi
砌	砌	¯tsɐi
沏	沏	¯tsɐi
讖	谶	¯tsɐm/¯tsam
齔	龀	¯tsɐn
趁	趁	¯tsɐn
襯	衬	¯tsɐn
嗅	嗅	¯tsɐu
臭	臭	¯tsɐu
糗	糗	¯tsɐu
溴	溴	¯tsɐu
湊	凑	¯tsɐu
挫	挫	¯tsɔ
銼	锉	¯tsɔ
錯	错	¯tsɔ
菜	菜	¯tsɔi
蔡	蔡	¯tsɔi
塞	塞	¯tsɔi
賽	赛	¯tsɔi
錯	错	¯tsɔk
創	创	¯tsɔŋ
尺	尺	¯tsɛk
呎	呎	¯tsɛk
赤	赤	¯tsɛk
秤	秤	¯tsɪŋ
稱	称	¯tsɪŋ
稱	称	¯tsɪŋ/¯tsɐŋ
脫	脱	¯tyt
彖	彖	¯tœn
退	退	¯tœy
蛻	蜕	¯tœy
屜	屉	¯tɐi
剃	剃	¯tɐi
替	替	¯tɐi
涕	涕	¯tɐi
嚏	嚏	¯tɐi
褪	褪	¯tɐn
透	透	¯tɐu
唾	唾	¯tɔ/¯tɛu
庹	庹	¯tɔk
託	托	¯tɔk
橐	橐	¯tɔk
托	托	¯tɔk
拓	拓	¯tɔk
趟	趟	¯tɔŋ
蹚	蹚	¯tɔŋ
熨	熨	¯tɔŋ
燙	烫	¯tɔŋ
踢	踢	¯tɛk
聽	听	¯tɪŋ
痛	痛	¯tʊŋ
斡	斡	¯wat
挖	挖	¯wat
惡	恶	¯wu
慰	慰	¯wɐi
尉	尉	¯wɐi
蔚	蔚	¯wɐi
穢	秽	¯wɐi
畏	畏	¯wɐi
餵	喂	¯wɐi
喂	喂	¯wɐi
薈	荟	¯wɐi/_wui
蘊	蕴	¯wɐn
慍	愠	¯wɐn
醞	酝	¯wɐn
搵	揾	¯wɐn
懊	懊	¯ŋou
澳	澳	¯ŋou
奧	奥	¯ŋou
襖	袄	¯ŋou/´ŋou
盎	盎	¯ŋɔŋ/´ŋɔŋ
屭	屃	¯ɐi
縊	缢	¯ɐi
唉	唉	¯ɐi
暗	暗	¯ɐm
慪	怄	¯ɐu
凹	凹	¯ɐu/'nɐp
愛	爱	¯ɔi
璦	瑷	¯ɔi
堊	垩	¯ɔk
惡	恶	¯ɔk
噁	恶	¯ɔk
按	按	¯ɔn
摁	摁	¯ɔn
案	案	¯ɔn
甕	瓮	¯ʊŋ
齆	齆	¯ʊŋ
啊	啊	´a
啞	哑	´a
俺	俺	´an
把	把	´ba
鈀	钯	´ba
靶	靶	´ba
捭	捭	´bai
襬	摆	´bai
擺	摆	´bai
舨	舨	´ban
板	板	´ban
坂	坂	´ban
版	版	´ban
闆	板	´ban
飽	饱	´bau
彼	彼	´bei
比	比	´bei
妣	妣	´bei
匕	匕	´bei/¯bei
貶	贬	´bin
匾	匾	´bin
扁	扁	´bin
表	表	´biu
婊	婊	´biu
圃	圃	´bou
保	保	´bou
鴇	鸨	´bou
寶	宝	´bou
堡	堡	´bou
補	补	´bou
葆	葆	´bou
畚	畚	´bun
本	本	´bun
苯	苯	´bun
稟	禀	´bɐn
品	品	´bɐn
綁	绑	´bɔŋ
榜	榜	´bɔŋ
蒡	蒡	´bɔŋ
膀	膀	´bɔŋ
餅	饼	´bɛŋ
炳	炳	´bɪŋ
餅	饼	´bɪŋ
屏	屏	´bɪŋ
秉	秉	´bɪŋ
丙	丙	´bɪŋ
打	打	´da
歹	歹	´dai
膽	胆	´dam
彈	弹	´dan
點	点	´dim
碘	碘	´din
墊	垫	´din
典	典	´din
屌	屌	´diu
賭	赌	´dou
堵	堵	´dou
島	岛	´dou
睹	睹	´dou
搗	捣	´dou
倒	倒	´dou
短	短	´dyn
嶄	崭	´dzam
斬	斩	´dzam
攢	攒	´dzan
趲	趱	´dzan
盞	盏	´dzan
爪	爪	´dzau
找	找	´dzau
滓	滓	´dzi
芷	芷	´dzi
趾	趾	´dzi
子	子	´dzi
止	止	´dzi
酯	酯	´dzi
祉	祉	´dzi
籽	籽	´dzi
秭	秭	´dzi
梓	梓	´dzi
咫	咫	´dzi
仔	仔	´dzi
只	只	´dzi
指	指	´dzi
紙	纸	´dzi
旨	旨	´dzi
紫	紫	´dzi
姊	姊	´dzi
址	址	´dzi
碾	碾	´dzin
輾	辗	´dzin
展	展	´dzin
剪	剪	´dzin
翦	翦	´dzin
闡	阐	´dzin/´tsin
沼	沼	´dziu
剿	剿	´dziu
組	组	´dzou
棗	枣	´dzou
澡	澡	´dzou
駔	驵	´dzou
藻	藻	´dzou
祖	祖	´dzou
蚤	蚤	´dzou
早	早	´dzou
煮	煮	´dzy
主	主	´dzy
轉	转	´dzyn
傳	传	´dzyn
纂	纂	´dzyn
准	准	´dzœn
隼	隼	´dzœn
儘	尽	´dzœn
準	准	´dzœn
沮	沮	´dzœy
咀	咀	´dzœy
齟	龃	´dzœy
嘴	嘴	´dzœy
掌	掌	´dzœŋ
槳	桨	´dzœŋ
獎	奖	´dzœŋ
蔣	蒋	´dzœŋ
長	长	´dzœŋ
漲	涨	´dzœŋ/¯dzœŋ
濟	济	´dzɐi
仔	仔	´dzɐi
枕	枕	´dzɐm
怎	怎	´dzɐm
疹	疹	´dzɐn
軫	轸	´dzɐn/´tsɐn
帚	帚	´dzɐu
走	走	´dzɐu
酒	酒	´dzɐu
肘	肘	´dzɐu
阻	阻	´dzɔ
左	左	´dzɔ
俎	俎	´dzɔ
崽	崽	´dzɔi
宰	宰	´dzɔi
載	载	´dzɔi
駔	驵	´dzɔŋ
姐	姐	´dzɛ
者	者	´dzɛ
整	整	´dzɪŋ
井	井	´dzɪŋ/´dzɛŋ
種	种	´dzʊŋ
腫	肿	´dzʊŋ
總	总	´dzʊŋ
邸	邸	´dɐi
詆	诋	´dɐi
柢	柢	´dɐi
底	底	´dɐi
骶	骶	´dɐi
抵	抵	´dɐi
墩	墩	´dɐn
斗	斗	´dɐu
蚪	蚪	´dɐu
陡	陡	´dɐu
抖	抖	´dɐu
等	等	´dɐŋ
跺	跺	´dɔ
躲	躲	´dɔ
剁	剁	´dɔ/¯dœk
朵	朵	´dɔ/´dɛu
擋	挡	´dɔŋ
黨	党	´dɔŋ
嗲	嗲	´dɛ
頂	顶	´dɪŋ
鼎	鼎	´dɪŋ
酊	酊	´dɪŋ
董	董	´dʊŋ
懂	懂	´dʊŋ
踵	踵	´dʊŋ
欸	欸	´ei
犯	犯	´fan
反	反	´fan
返	返	´fan
悱	悱	´fei
誹	诽	´fei
斐	斐	´fei
翡	翡	´fei
榧	榧	´fei
匪	匪	´fei
府	府	´fu
撫	抚	´fu
腑	腑	´fu
唬	唬	´fu
拊	拊	´fu
虎	虎	´fu
釜	釜	´fu
斧	斧	´fu
俯	俯	´fu
苦	苦	´fu
琥	琥	´fu
甫	甫	´fu
鮪	鲔	´fui
款	款	´fun
粉	粉	´fɐn
否	否	´fɐu
伙	伙	´fɔ
火	火	´fɔ
夥	伙	´fɔ
顆	颗	´fɔ
晃	晃	´fɔŋ
訪	访	´fɔŋ
幌	幌	´fɔŋ
紡	纺	´fɔŋ
彷	仿	´fɔŋ
恍	恍	´fɔŋ
仿	仿	´fɔŋ
檟	槚	´ga
假	假	´ga
賈	贾	´ga
架	架	´ga
斝	斝	´ga
尕	尕	´ga
解	解	´gai
蚧	蚧	´gai/´gwai
減	减	´gam
柬	柬	´gan
揀	拣	´gan
簡	简	´gan
繭	茧	´gan
鐧	锏	´gan
鹼	碱	´gan
餃	饺	´gau
姣	姣	´gau
狡	狡	´gau
皎	皎	´gau
佼	佼	´gau
鉸	铰	´gau
絞	绞	´gau
攪	搅	´gau
搞	搞	´gau
己	己	´gei
杞	杞	´gei
紀	纪	´gei
幾	几	´gei
檢	检	´gim
瞼	睑	´gim
撿	捡	´gim
矯	矫	´giu
繳	缴	´giu
稿	稿	´gou
槁	槁	´gou
鎬	镐	´gou
縞	缟	´gou
杲	杲	´gou
藁	藁	´gou
估	估	´gu
古	古	´gu
鼓	鼓	´gu
股	股	´gu
賈	贾	´gu
蠱	蛊	´gu
鈷	钴	´gu
牯	牯	´gu
莞	莞	´gun
館	馆	´gun
管	管	´gun
脘	脘	´gun
寡	寡	´gwa
柺	柺	´gwai
拐	拐	´gwai
蒯	蒯	´gwai
軌	轨	´gwɐi
鬼	鬼	´gwɐi
詭	诡	´gwɐi
晷	晷	´gwɐi
滾	滚	´gwɐn
裹	裹	´gwɔ
果	果	´gwɔ
廣	广	´gwɔŋ
獷	犷	´gwɔŋ
誑	诳	´gwɔŋ
炯	炯	´gwɪŋ
迥	迥	´gwɪŋ
卷	卷	´gyn
捲	卷	´gyn
矩	矩	´gœy
櫸	榉	´gœy
蒟	蒟	´gœy
齲	龋	´gœy
莒	莒	´gœy
舉	举	´gœy
感	感	´gɐm
敢	敢	´gɐm
橄	橄	´gɐm
錦	锦	´gɐm
緊	紧	´gɐn
饉	馑	´gɐn
堇	堇	´gɐn
謹	谨	´gɐn
僅	仅	´gɐn
瑾	瑾	´gɐn
韭	韭	´gɐu
九	九	´gɐu
久	久	´gɐu
狗	狗	´gɐu
苟	苟	´gɐu
玖	玖	´gɐu
枸	枸	´gɐu
糾	纠	´gɐu/´dɐu
耿	耿	´gɐŋ
埂	埂	´gɐŋ
梗	梗	´gɐŋ
亙	亘	´gɐŋ
哽	哽	´gɐŋ
鯁	鲠	´gɐŋ/´kɐŋ
改	改	´gɔi
趕	赶	´gɔn
擀	擀	´gɔn
桿	杆	´gɔn
港	港	´gɔŋ
講	讲	´gɔŋ
頸	颈	´gɛŋ
警	警	´gɪŋ
璟	璟	´gɪŋ
竟	竟	´gɪŋ
景	景	´gɪŋ
境	境	´gɪŋ
憬	憬	´gɪŋ
儆	儆	´gɪŋ
珙	珙	´gʊŋ
拱	拱	´gʊŋ
鞏	巩	´gʊŋ
考	考	´hau
拷	拷	´hau
巧	巧	´hau
囍	囍	´hei
喜	喜	´hei
豈	岂	´hei
起	起	´hei
險	险	´him
繾	缱	´hin
遣	遣	´hin
顯	显	´hin
譴	谴	´hin
蜆	蚬	´hin
曉	晓	´hiu
好	好	´hou
犬	犬	´hyn
畎	畎	´hyn
栩	栩	´hœy
詡	诩	´hœy
許	许	´hœy
煦	煦	´hœy/¯hœy
饗	飨	´hœŋ
餉	饷	´hœŋ
晌	晌	´hœŋ
響	响	´hœŋ
享	享	´hœŋ
砍	砍	´hɐm
坎	坎	´hɐm
懇	恳	´hɐn
狠	狠	´hɐn
墾	垦	´hɐn
很	很	´hɐn
口	口	´hɐu
肯	肯	´hɐŋ
啃	啃	´hɐŋ
可	可	´hɔ
嗬	嗬	´hɔ
坷	坷	´hɔ
岢	岢	´hɔ
塏	垲	´hɔi
鎧	铠	´hɔi
海	海	´hɔi
剴	剀	´hɔi
闓	闿	´hɔi
凱	凯	´hɔi
愷	恺	´hɔi
罕	罕	´hɔn
侃	侃	´hɔn
刊	刊	´hɔn/'hɔn
慷	慷	´hɔŋ/´kɔŋ
孔	孔	´hʊŋ
恐	恐	´hʊŋ
綺	绮	´ji
齮	齮	´ji
旖	旖	´ji
倚	倚	´ji
椅	椅	´ji
掩	掩	´jim
魘	魇	´jim
演	演	´jin
兗	兖	´jin
堰	堰	´jin
鼴	鼹	´jin
偃	偃	´jin
衍	衍	´jin/´hin
窈	窈	´jiu
擾	扰	´jiu
夭	夭	´jiu
繞	绕	´jiu/ˏjiu
瘀	瘀	´jy
嫗	妪	´jy
傴	伛	´jy
菀	菀	´jyn
宛	宛	´jyn
苑	苑	´jyn
婉	婉	´jyn
琬	琬	´jyn
鞅	鞅	´jœŋ
飲	饮	´jɐm
癮	瘾	´jɐn
隱	隐	´jɐn
忍	忍	´jɐn
柚	柚	´jɐu
黝	黝	´jɐu
影	影	´jɪŋ
映	映	´jɪŋ
慂	恿	´jʊŋ
冗	冗	´jʊŋ
臃	臃	´jʊŋ
蛹	蛹	´jʊŋ
佣	佣	´jʊŋ
湧	涌	´jʊŋ
俑	俑	´jʊŋ
踴	踊	´jʊŋ
擁	拥	´jʊŋ
卡	卡	´ka
蒈	蒈	´kai
楷	楷	´kai
鍇	锴	´kai/'gai
儈	侩	´kui
檜	桧	´kui
膾	脍	´kui
澮	浍	´kui
鄶	郐	´kui
鱠	鲙	´kui
繪	绘	´kui
聵	聩	´kui
獪	狯	´kui
劊	刽	´kui
賄	贿	´kui
潰	溃	´kui
會	会	´kui/_wui
侉	侉	´kwa
菌	菌	´kwɐn
捆	捆	´kwɐn
啟	启	´kɐi
茄	茄	´kɛ
頃	顷	´kɪŋ
佬	佬	´lou
戀	恋	´lyn
臠	脔	´lyn/ˌlyn
卵	卵	´lœn
兩	两	´lœŋ
摟	搂	´lɐu
裸	裸	´lɔ
郎	郎	´lɔŋ
咧	咧	´lɛ
摸	摸	´mɔ
捻	捻	´nim
朽	朽	´nɐu
鈕	钮	´nɐu
紐	纽	´nɐu
扭	扭	´nɐu
狃	狃	´nɐu
妞	妞	´nɐu
媼	媪	´ou
跑	跑	´pau
否	否	´pei
鄙	鄙	´pei
痞	痞	´pei
仳	仳	´pei
圮	圮	´pei
吡	吡	´pei
片	片	´pin
片	片	´pin
溥	溥	´pou
浦	浦	´pou
普	普	´pou
譜	谱	´pou
脯	脯	´pou/´fu
剖	剖	´pɐu
笸	笸	´pɔ
叵	叵	´pɔ
頗	颇	´pɔ
捧	捧	´pʊŋ/´bʊŋ
灑	洒	´sa
耍	耍	´sa
璽	玺	´sai
徙	徙	´sai
散	散	´san
稍	稍	´sau
省	省	´saŋ
死	死	´sei
屎	屎	´si
史	史	´si
使	使	´si
閃	闪	´sim
陝	陕	´sim
鮮	鲜	´sin
跣	跣	´sin
冼	冼	´sin
癬	癣	´sin
少	少	´siu
小	小	´siu
筱	筱	´siu
嫂	嫂	´sou
數	数	´sou
暑	暑	´sy
黍	黍	´sy
鼠	鼠	´sy
損	损	´syn
選	选	´syn
榫	榫	´sœn
筍	笋	´sœn
水	水	´sœy
鯗	鲞	´sœŋ
賞	赏	´sœŋ
想	想	´sœŋ
使	使	´sɐi
洗	洗	´sɐi
駛	驶	´sɐi
瀋	沈	´sɐm
沈	沈	´sɐm
嬸	婶	´sɐm
審	审	´sɐm
守	守	´sɐu
首	首	´sɐu
搜	搜	´sɐu
手	手	´sɐu
嗾	嗾	´sɐu
擻	擞	´sɐu
艘	艘	´sɐu/'sɐu
所	所	´sɔ
鎖	锁	´sɔ
嗩	唢	´sɔ
瑣	琐	´sɔ
搡	搡	´sɔŋ
爽	爽	´sɔŋ
嗓	嗓	´sɔŋ
寫	写	´sɛ
捨	舍	´sɛ
省	省	´sɪŋ
醒	醒	´sɪŋ/´sɛŋ
聳	耸	´sʊŋ
慫	怂	´sʊŋ
竦	竦	´sʊŋ
悚	悚	´sʊŋ
毯	毯	´tam
忐	忐	´tan
疸	疸	´tan
袒	袒	´tan
鉭	钽	´tan
坦	坦	´tan
亶	亶	´tan
舔	舔	´tim
腆	腆	´tin
討	讨	´tou
釷	钍	´tou
禱	祷	´tou
土	土	´tou
踩	踩	´tsai
踹	踹	´tsai
慘	惨	´tsam
產	产	´tsan
鏟	铲	´tsan
炒	炒	´tsau
吵	吵	´tsau
豕	豕	´tsi
矢	矢	´tsi
褫	褫	´tsi
跐	跐	´tsi
始	始	´tsi
此	此	´tsi
齒	齿	´tsi
侈	侈	´tsi
恥	耻	´tsi
諂	谄	´tsim
淺	浅	´tsin
悄	悄	´tsiu
悄	悄	´tsiu/'tsiu
草	草	´tsou
杵	杵	´tsy
貯	贮	´tsy
喘	喘	´tsyn
忖	忖	´tsyn
揣	揣	´tsyn
攛	撺	´tsyn/¯tsyn
蠢	蠢	´tsœn
揣	揣	´tsœy
娶	娶	´tsœy
取	取	´tsœy
搶	抢	´tsœŋ
寢	寝	´tsɐm
磣	碜	´tsɐm
哂	哂	´tsɐn
診	诊	´tsɐn
縝	缜	´tsɐn/´dzɐn
醜	丑	´tsɐu
丑	丑	´tsɐu
礎	础	´tsɔ
楚	楚	´tsɔ
采	采	´tsɔi
綵	彩	´tsɔi
彩	彩	´tsɔi
睬	睬	´tsɔi
採	采	´tsɔi
闖	闯	´tsɔŋ
敞	敞	´tsɔŋ
廠	厂	´tsɔŋ
氅	氅	´tsɔŋ
且	且	´tsɛ
扯	扯	´tsɛ
逞	逞	´tsɪŋ
騁	骋	´tsɪŋ
拯	拯	´tsɪŋ
請	请	´tsɪŋ/´tsɛŋ
寵	宠	´tsʊŋ
冢	冢	´tsʊŋ
腿	腿	´tœy
體	体	´tɐi
橢	椭	´tɔ
妥	妥	´tɔ
倘	倘	´tɔŋ
淌	淌	´tɔŋ
躺	躺	´tɔŋ
帑	帑	´tɔŋ
儻	傥	´tɔŋ
捅	捅	´tʊŋ
桶	桶	´tʊŋ
統	统	´tʊŋ
筒	筒	´tʊŋ/ˌtʊŋ
話	话	´wa
剮	剐	´wa
畫	画	´wa/_wa
玩	玩	´wan
綰	绾	´wan
塢	坞	´wu
滸	浒	´wu
莞	莞	´wun
腕	腕	´wun
碗	碗	´wun
豌	豌	´wun/'wun
玩	玩	´wun/_wun
惋	惋	´wun/´jyn
萎	萎	´wɐi
毀	毁	´wɐi
喟	喟	´wɐi
痿	痿	´wɐi
卉	卉	´wɐi
委	委	´wɐi
猥	猥	´wɐi
穩	稳	´wɐn
枉	枉	´wɔŋ
嗯	嗯	´ŋ̩
矮	矮	´ɐi
黯	黯	´ɐm
揞	揞	´ɐm
嘔	呕	´ɐu
毆	殴	´ɐu/'ɐu
藹	蔼	´ɔi
曖	暧	´ɔi
靉	叆	´ɔi
毐	毐	´ɔi
欸	欸	ˌei
礬	矾	ˌfan
繁	繁	ˌfan
帆	帆	ˌfan
藩	藩	ˌfan
凡	凡	ˌfan
煩	烦	ˌfan
釩	钒	ˌfan
樊	樊	ˌfan
蕃	蕃	ˌfan
梵	梵	ˌfan/_fan
肥	肥	ˌfei
腓	腓	ˌfei
乎	乎	ˌfu
芙	芙	ˌfu
符	符	ˌfu
扶	扶	ˌfu
汾	汾	ˌfɐn
墳	坟	ˌfɐn
焚	焚	ˌfɐn
浮	浮	ˌfɐu
妨	妨	ˌfɔŋ
房	房	ˌfɔŋ
防	防	ˌfɔŋ
縫	缝	ˌfʊŋ
馮	冯	ˌfʊŋ
逢	逢	ˌfʊŋ
縫	缝	ˌfʊŋ/_fʊŋ
遐	遐	ˌha
瑕	瑕	ˌha
蛤	蛤	ˌha
霞	霞	ˌha
諧	谐	ˌhai
骸	骸	ˌhai
鞋	鞋	ˌhai
孩	孩	ˌhai
涵	涵	ˌham
咸	咸	ˌham
銜	衔	ˌham
鹹	咸	ˌham
函	函	ˌham
閒	闲	ˌhan
癇	痫	ˌhan
嫺	娴	ˌhan
行	行	ˌhaŋ
嚎	嚎	ˌhou
嗥	嗥	ˌhou
壕	壕	ˌhou
豪	豪	ˌhou
蠔	蠔	ˌhou
毫	毫	ˌhou
號	号	ˌhou
奚	奚	ˌhɐi
鼷	鼷	ˌhɐi
兮	兮	ˌhɐi
酣	酣	ˌhɐm
晗	晗	ˌhɐm
含	含	ˌhɐm
痕	痕	ˌhɐn
瘊	瘊	ˌhɐu
喉	喉	ˌhɐu
侯	侯	ˌhɐu
猴	猴	ˌhɐu
篌	篌	ˌhɐu
桁	桁	ˌhɐŋ
行	行	ˌhɐŋ
恆	恒	ˌhɐŋ
衡	衡	ˌhɐŋ
荷	荷	ˌhɔ
河	河	ˌhɔ
何	何	ˌhɔ
寒	寒	ˌhɔn
鼾	鼾	ˌhɔn
韓	韩	ˌhɔn
汗	汗	ˌhɔn
邯	邯	ˌhɔn
航	航	ˌhɔŋ
降	降	ˌhɔŋ
行	行	ˌhɔŋ
吭	吭	ˌhɔŋ
杭	杭	ˌhɔŋ
鴻	鸿	ˌhʊŋ
虹	虹	ˌhʊŋ
熊	熊	ˌhʊŋ
洪	洪	ˌhʊŋ
雄	雄	ˌhʊŋ
紅	红	ˌhʊŋ
訌	讧	ˌhʊŋ/¯hʊŋ
誼	谊	ˌji
胰	胰	ˌji
頤	颐	ˌji
迤	迤	ˌji
儀	仪	ˌji
痍	痍	ˌji
宜	宜	ˌji
詒	诒	ˌji
姨	姨	ˌji
移	移	ˌji
怡	怡	ˌji
飴	饴	ˌji
兒	儿	ˌji
貽	贻	ˌji
咦	咦	ˌji
彞	彝	ˌji
而	而	ˌji
蛇	蛇	ˌji
眙	眙	ˌji
沂	沂	ˌji
夷	夷	ˌji
疑	疑	ˌji
炎	炎	ˌjim
鹽	盐	ˌjim
蚺	蚺	ˌjim
閻	阎	ˌjim
髯	髯	ˌjim
嫌	嫌	ˌjim
嚴	严	ˌjim
閆	闫	ˌjim
簷	檐	ˌjim/ˌsim
延	延	ˌjin
筵	筵	ˌjin
妍	妍	ˌjin
燃	燃	ˌjin
舷	舷	ˌjin
然	然	ˌjin
涎	涎	ˌjin
言	言	ˌjin
焉	焉	ˌjin
弦	弦	ˌjin
賢	贤	ˌjin
蜒	蜒	ˌjin
研	研	ˌjin
謠	谣	ˌjiu
堯	尧	ˌjiu
瑤	瑶	ˌjiu
搖	摇	ˌjiu
窯	窑	ˌjiu
遙	遥	ˌjiu
洮	洮	ˌjiu
徭	徭	ˌjiu
姚	姚	ˌjiu
嬈	娆	ˌjiu
颻	飖	ˌjiu
饒	饶	ˌjiu
鰩	鳐	ˌjiu
踰	逾	ˌjy
濡	濡	ˌjy
愚	愚	ˌjy
妤	妤	ˌjy
愉	愉	ˌjy
瑜	瑜	ˌjy
竽	竽	ˌjy
予	予	ˌjy
魚	鱼	ˌjy
隅	隅	ˌjy
渝	渝	ˌjy
萸	萸	ˌjy
盂	盂	ˌjy
漁	渔	ˌjy
娛	娱	ˌjy
嚅	嚅	ˌjy
臾	臾	ˌjy
逾	逾	ˌjy
禺	禺	ˌjy
虞	虞	ˌjy
俞	俞	ˌjy
諛	谀	ˌjy
茹	茹	ˌjy
餘	余	ˌjy
覦	觎	ˌjy
榆	榆	ˌjy
蝓	蝓	ˌjy
狳	狳	ˌjy
于	于	ˌjy
蠕	蠕	ˌjy
如	如	ˌjy
余	余	ˌjy
歟	欤	ˌjy
揄	揄	ˌjy
輿	舆	ˌjy
儒	儒	ˌjy
孺	孺	ˌjy/_jy
圓	圆	ˌjyn
芫	芫	ˌjyn
轅	辕	ˌjyn
元	元	ˌjyn
紈	纨	ˌjyn
沅	沅	ˌjyn
完	完	ˌjyn
袁	袁	ˌjyn
原	原	ˌjyn
緣	缘	ˌjyn
員	员	ˌjyn
眩	眩	ˌjyn
懸	悬	ˌjyn
沿	沿	ˌjyn
烷	烷	ˌjyn
鉛	铅	ˌjyn
園	园	ˌjyn
源	源	ˌjyn
玄	玄	ˌjyn
猿	猿	ˌjyn
丸	丸	ˌjyn/´jyn
蕤	蕤	ˌjœy
颺	飏	ˌjœŋ
瘍	疡	ˌjœŋ
烊	烊	ˌjœŋ
羊	羊	ˌjœŋ
楊	杨	ˌjœŋ
徉	徉	ˌjœŋ
瀼	瀼	ˌjœŋ
禳	禳	ˌjœŋ
穰	穰	ˌjœŋ
蘘	蘘	ˌjœŋ
陽	阳	ˌjœŋ
揚	扬	ˌjœŋ
佯	佯	ˌjœŋ
暘	旸	ˌjœŋ
洋	洋	ˌjœŋ
吟	吟	ˌjɐm
任	任	ˌjɐm
霪	霪	ˌjɐm
淫	淫	ˌjɐm
壬	壬	ˌjɐm
人	人	ˌjɐn
夤	夤	ˌjɐn
仁	仁	ˌjɐn
寅	寅	ˌjɐn
鈾	铀	ˌjɐu
遊	游	ˌjɐu
酋	酋	ˌjɐu
揉	揉	ˌjɐu
蚰	蚰	ˌjɐu
油	油	ˌjɐu
攸	攸	ˌjɐu
柔	柔	ˌjɐu
郵	邮	ˌjɐu
疣	疣	ˌjɐu
猶	犹	ˌjɐu
魷	鱿	ˌjɐu
游	游	ˌjɐu
由	由	ˌjɐu
尤	尤	ˌjɐu
蹂	蹂	ˌjɐu
悠	悠	ˌjɐu
耶	耶	ˌjɛ
爺	爷	ˌjɛ
揶	揶	ˌjɛ
椰	椰	ˌjɛ
邪	邪	ˌjɛ
贏	赢	ˌjɛŋ
滎	荥	ˌjɪŋ
鎣	蓥	ˌjɪŋ
迎	迎	ˌjɪŋ
瀠	潆	ˌjɪŋ
盈	盈	ˌjɪŋ
楹	楹	ˌjɪŋ
贏	赢	ˌjɪŋ
邢	邢	ˌjɪŋ
螢	萤	ˌjɪŋ
縈	萦	ˌjɪŋ
瑩	莹	ˌjɪŋ
凝	凝	ˌjɪŋ
營	营	ˌjɪŋ
熒	荧	ˌjɪŋ
型	型	ˌjɪŋ
瀛	瀛	ˌjɪŋ
嬴	嬴	ˌjɪŋ
仍	仍	ˌjɪŋ
蠅	蝇	ˌjɪŋ
刑	刑	ˌjɪŋ
形	形	ˌjɪŋ
陘	陉	ˌjɪŋ
瀅	滢	ˌjɪŋ/_jɪŋ
融	融	ˌjʊŋ
慵	慵	ˌjʊŋ
溶	溶	ˌjʊŋ
鱅	鳙	ˌjʊŋ
容	容	ˌjʊŋ
鏞	镛	ˌjʊŋ
茸	茸	ˌjʊŋ
熔	熔	ˌjʊŋ
蓉	蓉	ˌjʊŋ
傭	佣	ˌjʊŋ
戎	戎	ˌjʊŋ
庸	庸	ˌjʊŋ
榕	榕	ˌjʊŋ
絨	绒	ˌjʊŋ/´jʊŋ
琦	琦	ˌkei
旂	旂	ˌkei
琪	琪	ˌkei
俟	俟	ˌkei
鰭	鳍	ˌkei
耆	耆	ˌkei
蘄	蕲	ˌkei
祁	祁	ˌkei
祺	祺	ˌkei
旗	旗	ˌkei
麒	麒	ˌkei
奇	奇	ˌkei
岐	岐	ˌkei
萁	萁	ˌkei
其	其	ˌkei
祈	祈	ˌkei
淇	淇	ˌkei
歧	歧	ˌkei
棋	棋	ˌkei
期	期	ˌkei
鉗	钳	ˌkim
黔	黔	ˌkim
乾	乾	ˌkin
犍	犍	ˌkin
掮	掮	ˌkin
虔	虔	ˌkin
喬	乔	ˌkiu
僑	侨	ˌkiu
翹	翘	ˌkiu
蕎	荞	ˌkiu
橋	桥	ˌkiu
夔	夔	ˌkwɐi
睽	睽	ˌkwɐi
葵	葵	ˌkwɐi
暌	暌	ˌkwɐi
畦	畦	ˌkwɐi
攜	携	ˌkwɐi
馗	馗	ˌkwɐi
喹	喹	ˌkwɐi
揆	揆	ˌkwɐi/ˏkwɐi
群	群	ˌkwɐn
裙	裙	ˌkwɐn
狂	狂	ˌkwɔŋ
蜷	蜷	ˌkyn
拳	拳	ˌkyn
顴	颧	ˌkyn
權	权	ˌkyn
鬈	鬈	ˌkyn
朐	朐	ˌkœy
渠	渠	ˌkœy
瞿	瞿	ˌkœy
蠼	蠼	ˌkœy
璩	璩	ˌkœy
衢	衢	ˌkœy
強	强	ˌkœŋ
琴	琴	ˌkɐm
禽	禽	ˌkɐm
擒	擒	ˌkɐm
噙	噙	ˌkɐm
勤	勤	ˌkɐn
芹	芹	ˌkɐn
逑	逑	ˌkɐu
虯	虬	ˌkɐu
仇	仇	ˌkɐu
求	求	ˌkɐu
球	球	ˌkɐu
毬	毬	ˌkɐu
裘	裘	ˌkɐu
犰	犰	ˌkɐu
瘸	瘸	ˌkɛ
騎	骑	ˌkɛ
黥	黥	ˌkɪŋ
瓊	琼	ˌkɪŋ
鯨	鲸	ˌkɪŋ
擎	擎	ˌkɪŋ
穹	穹	ˌkʊŋ
邛	邛	ˌkʊŋ
窮	穷	ˌkʊŋ
藍	蓝	ˌlam
嵐	岚	ˌlam
襤	褴	ˌlam
籃	篮	ˌlam
婪	婪	ˌlam
襴	襕	ˌlan
蘭	兰	ˌlan
欄	栏	ˌlan
攔	拦	ˌlan
闌	阑	ˌlan
瀾	澜	ˌlan
斕	斓	ˌlan
梨	梨	ˌlei
縭	缡	ˌlei
璃	璃	ˌlei
籬	篱	ˌlei
狸	狸	ˌlei
罹	罹	ˌlei
釐	厘	ˌlei
離	离	ˌlei
蜊	蜊	ˌlei
鱺	鲡	ˌlei
漓	漓	ˌlei
廉	廉	ˌlim
簾	帘	ˌlim
帘	帘	ˌlim
鐮	镰	ˌlim
漣	涟	ˌlin
連	连	ˌlin
蓮	莲	ˌlin
憐	怜	ˌlin
鏈	链	ˌlin
鐐	镣	ˌliu
寮	寮	ˌliu
瞭	瞭	ˌliu
僚	僚	ˌliu
遼	辽	ˌliu
繚	缭	ˌliu
嘹	嘹	ˌliu
燎	燎	ˌliu
撩	撩	ˌliu
療	疗	ˌliu
聊	聊	ˌliu
獠	獠	ˌliu
寥	寥	ˌliu
蘆	芦	ˌlou
臚	胪	ˌlou
癆	痨	ˌlou
顱	颅	ˌlou
盧	卢	ˌlou
爐	炉	ˌlou
廬	庐	ˌlou
勞	劳	ˌlou
牢	牢	ˌlou
醪	醪	ˌlou
轤	轳	ˌlou
嘮	唠	ˌlou
鱸	鲈	ˌlou
瀘	泸	ˌlou
鸞	鸾	ˌlyn
灤	滦	ˌlyn
巒	峦	ˌlyn
攣	挛	ˌlyn
孿	孪	ˌlyn
聯	联	ˌlyn
欒	栾	ˌlyn
崙	仑	ˌlœn
鱗	鳞	ˌlœn
輪	轮	ˌlœn
遴	遴	ˌlœn
倫	伦	ˌlœn
粼	粼	ˌlœn
掄	抡	ˌlœn
璘	璘	ˌlœn
淪	沦	ˌlœn
侖	仑	ˌlœn
麟	麟	ˌlœn
磷	磷	ˌlœn
論	论	ˌlœn
圇	囵	ˌlœn
綸	纶	ˌlœn
鄰	邻	ˌlœn
嶙	嶙	ˌlœn
驢	驴	ˌlœy
羸	羸	ˌlœy
纍	累	ˌlœy
櫚	榈	ˌlœy
嫘	嫘	ˌlœy
擂	擂	ˌlœy
閭	闾	ˌlœy
鐳	镭	ˌlœy
縲	缧	ˌlœy
雷	雷	ˌlœy
騾	骡	ˌlœy/ˌlɔ
莨	莨	ˌlœŋ
梁	梁	ˌlœŋ
涼	凉	ˌlœŋ
糧	粮	ˌlœŋ
量	量	ˌlœŋ
粱	粱	ˌlœŋ
良	良	ˌlœŋ
黎	黎	ˌlɐi
犂	犂	ˌlɐi
藜	藜	ˌlɐi
犁	犁	ˌlɐi
蠡	蠡	ˌlɐi/ˏlɐi
臨	临	ˌlɐm
林	林	ˌlɐm
啉	啉	ˌlɐm
淋	淋	ˌlɐm
琳	琳	ˌlɐm
霖	霖	ˌlɐm
流	流	ˌlɐu
琉	琉	ˌlɐu
樓	楼	ˌlɐu
硫	硫	ˌlɐu
騮	骝	ˌlɐu
僂	偻	ˌlɐu
髏	髅	ˌlɐu
瘤	瘤	ˌlɐu
撈	捞	ˌlɐu
劉	刘	ˌlɐu
婁	娄	ˌlɐu
留	留	ˌlɐu
瀏	浏	ˌlɐu
榴	榴	ˌlɐu
螻	螻	ˌlɐu
玀	猡	ˌlɔ
籮	箩	ˌlɔ
蘿	萝	ˌlɔ
鑼	锣	ˌlɔ
羅	罗	ˌlɔ
邏	逻	ˌlɔ
螺	螺	ˌlɔ/´lɔ
萊	莱	ˌlɔi
來	来	ˌlɔi
淶	涞	ˌlɔi
崍	崃	ˌlɔi
徠	徕	ˌlɔi
鋃	锒	ˌlɔŋ
榔	榔	ˌlɔŋ
廊	廊	ˌlɔŋ
莨	莨	ˌlɔŋ
郎	郎	ˌlɔŋ
瑯	琅	ˌlɔŋ
螂	螂	ˌlɔŋ
狼	狼	ˌlɔŋ
齡	龄	ˌlɪŋ
令	令	ˌlɪŋ
聆	聆	ˌlɪŋ
陵	陵	ˌlɪŋ
凌	凌	ˌlɪŋ
伶	伶	ˌlɪŋ
苓	苓	ˌlɪŋ
呤	呤	ˌlɪŋ
櫺	櫺	ˌlɪŋ
翎	翎	ˌlɪŋ
囹	囹	ˌlɪŋ
玲	玲	ˌlɪŋ
蛉	蛉	ˌlɪŋ
羚	羚	ˌlɪŋ
稜	棱	ˌlɪŋ
綾	绫	ˌlɪŋ
靈	灵	ˌlɪŋ
菱	菱	ˌlɪŋ
鈴	铃	ˌlɪŋ
零	零	ˌlɪŋ
鯪	鲮	ˌlɪŋ
窿	窿	ˌlʊŋ
朧	胧	ˌlʊŋ
嚨	咙	ˌlʊŋ
矓	眬	ˌlʊŋ
聾	聋	ˌlʊŋ
隆	隆	ˌlʊŋ
龍	龙	ˌlʊŋ
籠	笼	ˌlʊŋ
蘢	茏	ˌlʊŋ
瓏	珑	ˌlʊŋ
曨	昽	ˌlʊŋ
麻	麻	ˌma
蟆	蟆	ˌma
痲	麻	ˌma
埋	埋	ˌmai
霾	霾	ˌmai/ˌmɐi
饅	馒	ˌman
蠻	蛮	ˌman
謾	谩	ˌman
鰻	鳗	ˌman
蔓	蔓	ˌman
茅	茅	ˌmau
矛	矛	ˌmau
盲	盲	ˌmaŋ
眉	眉	ˌmei
湄	湄	ˌmei
蘼	蘼	ˌmei
薇	薇	ˌmei
麋	麋	ˌmei
微	微	ˌmei
楣	楣	ˌmei
嵋	嵋	ˌmei
靡	靡	ˌmei
瀰	弥	ˌmei/ˌnei
獼	猕	ˌmei/ˌnei
綿	绵	ˌmin
棉	棉	ˌmin
眠	眠	ˌmin
苗	苗	ˌmiu
描	描	ˌmiu
瞄	瞄	ˌmiu
模	模	ˌmou
髦	髦	ˌmou
摹	摹	ˌmou
謨	谟	ˌmou
誣	诬	ˌmou
毛	毛	ˌmou
無	无	ˌmou
蕪	芜	ˌmou
毋	毋	ˌmou
膜	膜	ˌmou
巫	巫	ˌmou
氂	牦	ˌmou/ˌlei
玫	玫	ˌmui
霉	霉	ˌmui
媒	媒	ˌmui
煤	煤	ˌmui
酶	酶	ˌmui
梅	梅	ˌmui
枚	枚	ˌmui
莓	莓	ˌmui
們	们	ˌmun
捫	扪	ˌmun
瞞	瞒	ˌmun
門	门	ˌmun
鞔	鞔	ˌmun
迷	迷	ˌmɐi
謎	谜	ˌmɐi
醚	醚	ˌmɐi
瞇	眯	ˌmɐi
苠	苠	ˌmɐn
忞	忞	ˌmɐn
旻	旻	ˌmɐn
岷	岷	ˌmɐn
緡	缗	ˌmɐn
雯	雯	ˌmɐn
珉	珉	ˌmɐn
紋	纹	ˌmɐn
玟	玟	ˌmɐn
氓	氓	ˌmɐn
聞	闻	ˌmɐn
文	文	ˌmɐn
民	民	ˌmɐn
謀	谋	ˌmɐu
眸	眸	ˌmɐu
繆	缪	ˌmɐu
牟	牟	ˌmɐu
萌	萌	ˌmɐŋ
盟	盟	ˌmɐŋ
磨	磨	ˌmɔ
蘑	蘑	ˌmɔ
饃	馍	ˌmɔ
虻	虻	ˌmɔŋ
莽	莽	ˌmɔŋ
茫	茫	ˌmɔŋ
鋩	铓	ˌmɔŋ
忘	忘	ˌmɔŋ
氓	氓	ˌmɔŋ
芒	芒	ˌmɔŋ
亡	亡	ˌmɔŋ
忙	忙	ˌmɔŋ
鳴	鸣	ˌmɪŋ
洺	洺	ˌmɪŋ
冥	冥	ˌmɪŋ
明	明	ˌmɪŋ
溟	溟	ˌmɪŋ
名	名	ˌmɪŋ
螟	螟	ˌmɪŋ
暝	暝	ˌmɪŋ/_mɪŋ
銘	铭	ˌmɪŋ/ˏmɪŋ
瞑	瞑	ˌmɪŋ/ˏmɪŋ
朦	朦	ˌmʊŋ
矇	蒙	ˌmʊŋ
蒙	蒙	ˌmʊŋ
檬	檬	ˌmʊŋ
曚	曚	ˌmʊŋ
濛	蒙	ˌmʊŋ
哪	哪	ˌna
娜	娜	ˌna
南	南	ˌna
拿	拿	ˌna
南	南	ˌnam
囡	囡	ˌnam
男	男	ˌnam
喃	喃	ˌnam
楠	楠	ˌnam
難	难	ˌnan
猱	猱	ˌnau
鐃	铙	ˌnau
錨	锚	ˌnau
撓	挠	ˌnau
橈	桡	ˌnau
尼	尼	ˌnei
怩	怩	ˌnei
鈮	铌	ˌnei
彌	弥	ˌnei
妮	妮	ˌnei
鯰	鲇	ˌnim
年	年	ˌnin
奴	奴	ˌnou
娘	娘	ˌnœŋ
泥	泥	ˌnɐi
呢	呢	ˌnɐi/ˌnei
能	能	ˌnɐŋ
挪	挪	ˌnɔ
挼	挼	ˌnɔ
囔	囔	ˌnɔŋ
囊	囊	ˌnɔŋ
饢	馕	ˌnɔŋ
瓤	瓤	ˌnɔŋ
獰	狞	ˌnɪŋ
寧	宁	ˌnɪŋ
嚀	咛	ˌnɪŋ
檸	柠	ˌnɪŋ
儂	侬	ˌnʊŋ
膿	脓	ˌnʊŋ
農	农	ˌnʊŋ
濃	浓	ˌnʊŋ
爬	爬	ˌpa
杷	杷	ˌpa
耙	耙	ˌpa
扒	扒	ˌpa
琶	琶	ˌpa
排	排	ˌpai
俳	俳	ˌpai
牌	牌	ˌpai
庖	庖	ˌpau
麅	狍	ˌpau
匏	匏	ˌpau
咆	咆	ˌpau
刨	刨	ˌpau
硼	硼	ˌpaŋ
澎	澎	ˌpaŋ
鵬	鹏	ˌpaŋ
彭	彭	ˌpaŋ
膨	膨	ˌpaŋ
棚	棚	ˌpaŋ
脾	脾	ˌpei
疲	疲	ˌpei
琵	琵	ˌpei
貔	貔	ˌpei
枇	枇	ˌpei
蜱	蜱	ˌpei
皮	皮	ˌpei
毗	毗	ˌpei
郫	郫	ˌpei
邳	邳	ˌpei
便	便	ˌpin
駢	骈	ˌpin
嫖	嫖	ˌpiu
瓢	瓢	ˌpiu
朴	朴	ˌpiu
菩	菩	ˌpou
脯	脯	ˌpou
匍	匍	ˌpou
袍	袍	ˌpou
蒲	蒲	ˌpou
莆	莆	ˌpou
葡	葡	ˌpou
賠	赔	ˌpui
裴	裴	ˌpui
培	培	ˌpui
陪	陪	ˌpui
徘	徘	ˌpui
蟠	蟠	ˌpun
盤	盘	ˌpun
磐	磐	ˌpun
盆	盆	ˌpun
槃	槃	ˌpun
蹣	蹒	ˌpun/ˌmun
嬪	嫔	ˌpɐn
頻	频	ˌpɐn
顰	颦	ˌpɐn
貧	贫	ˌpɐn
抔	抔	ˌpɐu
朋	朋	ˌpɐŋ
憑	凭	ˌpɐŋ
婆	婆	ˌpɔ
鄱	鄱	ˌpɔ/¯bɔ
彷	彷	ˌpɔŋ
磅	磅	ˌpɔŋ
旁	旁	ˌpɔŋ
滂	滂	ˌpɔŋ
螃	螃	ˌpɔŋ
膀	膀	ˌpɔŋ
龐	庞	ˌpɔŋ
瓶	瓶	ˌpɪŋ
坪	坪	ˌpɪŋ
評	评	ˌpɪŋ
萍	萍	ˌpɪŋ
平	平	ˌpɪŋ
屏	屏	ˌpɪŋ
蘋	苹	ˌpɪŋ
芃	芃	ˌpʊŋ
篷	篷	ˌpʊŋ
蓬	蓬	ˌpʊŋ/ˌfʊŋ
孱	孱	ˌsan
潺	潺	ˌsan
鰣	鲥	ˌsi
匙	匙	ˌsi
蒔	莳	ˌsi
時	时	ˌsi
禪	禅	ˌsim
單	单	ˌsim
蟾	蟾	ˌsim
蟬	蝉	ˌsin
殊	殊	ˌsy
薯	薯	ˌsy
旋	旋	ˌsyn
船	船	ˌsyn
璇	璇	ˌsyn
漩	漩	ˌsyn
脣	唇	ˌsœn
醇	醇	ˌsœn
淳	淳	ˌsœn
純	纯	ˌsœn
鶉	鹑	ˌsœn/'tsœn
誰	谁	ˌsœy
垂	垂	ˌsœy
嘗	尝	ˌsœŋ
嚐	尝	ˌsœŋ
嫦	嫦	ˌsœŋ
徜	徜	ˌsœŋ
裳	裳	ˌsœŋ
償	偿	ˌsœŋ
常	常	ˌsœŋ
涔	涔	ˌsɐm
岑	岑	ˌsɐm
忱	忱	ˌsɐm
梣	梣	ˌsɐm
辰	辰	ˌsɐn
神	神	ˌsɐn
晨	晨	ˌsɐn
臣	臣	ˌsɐn
仇	仇	ˌsɐu
愁	愁	ˌsɐu
傻	傻	ˌsɔ
蛇	蛇	ˌsɛ
畲	畲	ˌsɛ
城	城	ˌsɪŋ
繩	绳	ˌsɪŋ
誠	诚	ˌsɪŋ
澠	渑	ˌsɪŋ
乘	乘	ˌsɪŋ
盛	盛	ˌsɪŋ
承	承	ˌsɪŋ
成	成	ˌsɪŋ
丞	丞	ˌsɪŋ
崇	崇	ˌsʊŋ
潭	潭	ˌtam
談	谈	ˌtam
曇	昙	ˌtam
澹	澹	ˌtam
譚	谭	ˌtam
郯	郯	ˌtam
痰	痰	ˌtam
覃	覃	ˌtam
壇	坛	ˌtan
檀	檀	ˌtan
彈	弹	ˌtan
恬	恬	ˌtim
甜	甜	ˌtim
填	填	ˌtin
田	田	ˌtin
闐	阗	ˌtin
鈿	钿	ˌtin
滇	滇	ˌtin/'din
鈿	钿	ˌtin/_din
齠	龆	ˌtiu
髫	髫	ˌtiu
笤	笤	ˌtiu
條	条	ˌtiu
調	调	ˌtiu
迢	迢	ˌtiu
鼗	鼗	ˌtou
洮	洮	ˌtou
掏	掏	ˌtou
屠	屠	ˌtou
萄	萄	ˌtou
陶	陶	ˌtou
檮	梼	ˌtou
啕	啕	ˌtou
途	途	ˌtou
塗	涂	ˌtou
涂	涂	ˌtou
濤	涛	ˌtou
荼	荼	ˌtou
淘	淘	ˌtou
逃	逃	ˌtou
圖	图	ˌtou
徒	徒	ˌtou
桃	桃	ˌtou
茬	茬	ˌtsa
碴	碴	ˌtsa
搽	搽	ˌtsa
查	查	ˌtsa
茶	茶	ˌtsa
垞	垞	ˌtsa
槎	槎	ˌtsa
儕	侪	ˌtsai
柴	柴	ˌtsai
豺	豺	ˌtsai
蠶	蚕	ˌtsam
讒	谗	ˌtsam
慚	惭	ˌtsam
饞	馋	ˌtsam
殘	残	ˌtsan
巢	巢	ˌtsau
橙	橙	ˌtsaŋ/´tsaŋ
辭	辞	ˌtsi
祠	祠	ˌtsi
篪	篪	ˌtsi
馳	驰	ˌtsi
慈	慈	ˌtsi
詞	词	ˌtsi
磁	磁	ˌtsi
瓷	瓷	ˌtsi
池	池	ˌtsi
墀	墀	ˌtsi
踟	踟	ˌtsi
糍	糍	ˌtsi
持	持	ˌtsi
匙	匙	ˌtsi
遲	迟	ˌtsi
臍	脐	ˌtsi
茌	茌	ˌtsi
弛	弛	ˌtsi
潛	潜	ˌtsim
前	前	ˌtsin
錢	钱	ˌtsin
纏	缠	ˌtsin
潮	潮	ˌtsiu
朝	朝	ˌtsiu
憔	憔	ˌtsiu
瞧	瞧	ˌtsiu
樵	樵	ˌtsiu
嘈	嘈	ˌtsou
曹	曹	ˌtsou
漕	漕	ˌtsou
槽	槽	ˌtsou
蹰	蹰	ˌtsy
廚	厨	ˌtsy/ˌtsœy
輇	辁	ˌtsyn
筌	筌	ˌtsyn
泉	泉	ˌtsyn
詮	诠	ˌtsyn
存	存	ˌtsyn
銓	铨	ˌtsyn
傳	传	ˌtsyn
荃	荃	ˌtsyn
痊	痊	ˌtsyn
全	全	ˌtsyn
醛	醛	ˌtsyn
馴	驯	ˌtsœn
旬	旬	ˌtsœn
循	循	ˌtsœn
秦	秦	ˌtsœn
巡	巡	ˌtsœn
嗪	嗪	ˌtsœn
螓	螓	ˌtsœn
隋	隋	ˌtsœy
滁	滁	ˌtsœy
隨	随	ˌtsœy
槌	槌	ˌtsœy
徐	徐	ˌtsœy
除	除	ˌtsœy
錘	锤	ˌtsœy
捶	捶	ˌtsœy
蜍	蜍	ˌtsœy
長	长	ˌtsœŋ
薔	蔷	ˌtsœŋ
牆	墙	ˌtsœŋ
祥	祥	ˌtsœŋ
戕	戕	ˌtsœŋ
場	场	ˌtsœŋ
詳	详	ˌtsœŋ
腸	肠	ˌtsœŋ
翔	翔	ˌtsœŋ
檣	樯	ˌtsœŋ
薺	荠	ˌtsɐi
齊	齐	ˌtsɐi
沉	沉	ˌtsɐm
蕁	荨	ˌtsɐm
鱘	鲟	ˌtsɐm
尋	寻	ˌtsɐm
塵	尘	ˌtsɐn
陳	陈	ˌtsɐn
惆	惆	ˌtsɐu
籌	筹	ˌtsɐu
疇	畴	ˌtsɐu
躊	踌	ˌtsɐu
綢	绸	ˌtsɐu
酬	酬	ˌtsɐu
遒	遒	ˌtsɐu
儔	俦	ˌtsɐu
仇	仇	ˌtsɐu
囚	囚	ˌtsɐu
稠	稠	ˌtsɐu
泅	泅	ˌtsɐu
曾	曾	ˌtsɐŋ
層	层	ˌtsɐŋ
鋤	锄	ˌtsɔ
才	才	ˌtsɔi
財	财	ˌtsɔi
裁	裁	ˌtsɔi
材	材	ˌtsɔi
藏	藏	ˌtsɔŋ
床	床	ˌtsɔŋ
輋	輋	ˌtsɛ
邪	邪	ˌtsɛ
斜	斜	ˌtsɛ
呈	呈	ˌtsɪŋ
懲	惩	ˌtsɪŋ
澄	澄	ˌtsɪŋ
情	情	ˌtsɪŋ
程	程	ˌtsɪŋ
晴	晴	ˌtsɪŋ
埕	埕	ˌtsɪŋ
澂	澂	ˌtsɪŋ
重	重	ˌtsʊŋ
叢	丛	ˌtsʊŋ
松	松	ˌtsʊŋ
琮	琮	ˌtsʊŋ
蟲	虫	ˌtsʊŋ
從	从	ˌtsʊŋ
屯	屯	ˌtyn
糰	团	ˌtyn
臀	臀	ˌtyn
豚	豚	ˌtyn
團	团	ˌtyn
囤	囤	ˌtyn
頹	颓	ˌtœy
堤	堤	ˌtɐi
啼	啼	ˌtɐi
鵜	鹈	ˌtɐi
緹	缇	ˌtɐi
醍	醍	ˌtɐi
題	题	ˌtɐi
蹄	蹄	ˌtɐi
提	提	ˌtɐi
頭	头	ˌtɐu
投	投	ˌtɐu
骰	骰	ˌtɐu/'sik
藤	藤	ˌtɐŋ
謄	誊	ˌtɐŋ
疼	疼	ˌtɐŋ
滕	滕	ˌtɐŋ
騰	腾	ˌtɐŋ
沱	沱	ˌtɔ
陀	陀	ˌtɔ
佗	佗	ˌtɔ
馱	驮	ˌtɔ
舵	舵	ˌtɔ
鴕	鸵	ˌtɔ
駝	驼	ˌtɔ
台	台	ˌtɔi
枱	台	ˌtɔi
跆	跆	ˌtɔi
苔	苔	ˌtɔi
颱	台	ˌtɔi
薹	薹	ˌtɔi
抬	抬	ˌtɔi
幢	幢	ˌtɔŋ
螳	螳	ˌtɔŋ
溏	溏	ˌtɔŋ
堂	堂	ˌtɔŋ
棠	棠	ˌtɔŋ
膛	膛	ˌtɔŋ
唐	唐	ˌtɔŋ
醣	醣	ˌtɔŋ
塘	塘	ˌtɔŋ
糖	糖	ˌtɔŋ/´tɔŋ
搪	搪	ˌtɔŋ/ˏtɔŋ
婷	婷	ˌtɪŋ
廷	廷	ˌtɪŋ
庭	庭	ˌtɪŋ
亭	亭	ˌtɪŋ
蜓	蜓	ˌtɪŋ
停	停	ˌtɪŋ
霆	霆	ˌtɪŋ
峒	峒	ˌtʊŋ
潼	潼	ˌtʊŋ
桐	桐	ˌtʊŋ
佟	佟	ˌtʊŋ
瞳	瞳	ˌtʊŋ
彤	彤	ˌtʊŋ
僮	僮	ˌtʊŋ
童	童	ˌtʊŋ
同	同	ˌtʊŋ
酮	酮	ˌtʊŋ
銅	铜	ˌtʊŋ
衕	同	ˌtʊŋ
驊	骅	ˌwa
華	华	ˌwa
划	划	ˌwa/'wa
懷	怀	ˌwai
槐	槐	ˌwai
淮	淮	ˌwai
頑	顽	ˌwan
鬟	鬟	ˌwan
還	还	ˌwan
環	环	ˌwan
寰	寰	ˌwan
玩	玩	ˌwan
橫	横	ˌwaŋ
葫	葫	ˌwu
餬	糊	ˌwu
衚	胡	ˌwu
煳	煳	ˌwu
猢	猢	ˌwu
瑚	瑚	ˌwu
蝴	蝴	ˌwu
狐	狐	ˌwu
湖	湖	ˌwu
壺	壶	ˌwu
鬍	胡	ˌwu
糊	糊	ˌwu
鶘	鹕	ˌwu
醐	醐	ˌwu
胡	胡	ˌwu
弧	弧	ˌwu
洄	洄	ˌwui
回	回	ˌwui
徊	徊	ˌwui
迴	回	ˌwui
蛔	蛔	ˌwui
垣	垣	ˌwun
桓	桓	ˌwun
援	援	ˌwun/ˌjyn
帷	帷	ˌwɐi
唯	唯	ˌwɐi
遺	遗	ˌwɐi
維	维	ˌwɐi
闈	闱	ˌwɐi
濰	潍	ˌwɐi
圍	围	ˌwɐi
惟	惟	ˌwɐi
桅	桅	ˌwɐi
為	为	ˌwɐi
違	违	ˌwɐi
暈	晕	ˌwɐn
筠	筠	ˌwɐn
云	云	ˌwɐn
蕓	芸	ˌwɐn
耘	耘	ˌwɐn
妘	妘	ˌwɐn
勻	匀	ˌwɐn
渾	浑	ˌwɐn
魂	魂	ˌwɐn
雲	云	ˌwɐn
昀	昀	ˌwɐn
餛	馄	ˌwɐn
鋆	鋆	ˌwɐn
芸	芸	ˌwɐn
紜	纭	ˌwɐn
琿	珲	ˌwɐn
宏	宏	ˌwɐŋ
弘	弘	ˌwɐŋ
閎	闳	ˌwɐŋ
禾	禾	ˌwɔ
和	和	ˌwɔ
簧	簧	ˌwɔŋ
潢	潢	ˌwɔŋ
磺	磺	ˌwɔŋ
皇	皇	ˌwɔŋ
惶	惶	ˌwɔŋ
凰	凰	ˌwɔŋ
黃	黄	ˌwɔŋ
遑	遑	ˌwɔŋ
蝗	蝗	ˌwɔŋ
徨	徨	ˌwɔŋ
蟥	蟥	ˌwɔŋ
王	王	ˌwɔŋ
煌	煌	ˌwɔŋ
隍	隍	ˌwɔŋ
榮	荣	ˌwɪŋ
嶸	嵘	ˌwɪŋ
牙	牙	ˌŋa
衙	衙	ˌŋa
芽	芽	ˌŋa
捱	挨	ˌŋai
厓	厓	ˌŋai
睚	睚	ˌŋai
崖	崖	ˌŋai
涯	涯	ˌŋai
岩	岩	ˌŋam
癌	癌	ˌŋam
顏	颜	ˌŋan
餚	肴	ˌŋau
淆	淆	ˌŋau
爻	爻	ˌŋau
螯	螯	ˌŋou
獒	獒	ˌŋou
敖	敖	ˌŋou
翱	翱	ˌŋou
鰲	鳌	ˌŋou
驁	骜	ˌŋou
遨	遨	ˌŋou/_ŋou
熬	熬	ˌŋou/ˌŋɐu
霓	霓	ˌŋɐi
巍	巍	ˌŋɐi
危	危	ˌŋɐi
猊	猊	ˌŋɐi
倪	倪	ˌŋɐi
垠	垠	ˌŋɐn
齦	龈	ˌŋɐn
齗	龂	ˌŋɐn
銀	银	ˌŋɐn
沂	沂	ˌŋɐn
牛	牛	ˌŋɐu
哦	哦	ˌŋɔ
訛	讹	ˌŋɔ
鵝	鹅	ˌŋɔ
峨	峨	ˌŋɔ
娥	娥	ˌŋɔ
俄	俄	ˌŋɔ
蛾	蛾	ˌŋɔ
莪	莪	ˌŋɔ
呆	呆	ˌŋɔi
昂	昂	ˌŋɔŋ
蜈	蜈	ˌŋ̩
吾	吾	ˌŋ̩
梧	梧	ˌŋ̩
吳	吴	ˌŋ̩
鼯	鼯	ˌŋ̩
哦	哦	ˌɔ
撣	掸	ˏdan
撢	掸	ˏdan
這	这	ˏdzɛ/¯dzɛ
婦	妇	ˏfu
忿	忿	ˏfɐn
憤	愤	ˏfɐn
奮	奋	ˏfɐn
獬	獬	ˏhai
蟹	蟹	ˏhai
駭	骇	ˏhai
檻	槛	ˏham
頷	颔	ˏhɐm
厚	厚	ˏhɐu
旱	旱	ˏhɔn
脛	胫	ˏhɪŋ/¯gɪŋ
也	也	ˏja
爾	尔	ˏji
以	以	ˏji
洱	洱	ˏji
矣	矣	ˏji
迤	迤	ˏji
邇	迩	ˏji
已	已	ˏji
議	议	ˏji
耳	耳	ˏji
擬	拟	ˏji
染	染	ˏjim
苒	苒	ˏjim
儼	俨	ˏjim
冉	冉	ˏjim
舀	舀	ˏjiu
予	予	ˏjy
雨	雨	ˏjy
齬	龉	ˏjy
圄	圄	ˏjy
瑀	瑀	ˏjy
羽	羽	ˏjy
語	语	ˏjy
敔	敔	ˏjy
貐	貐	ˏjy
乳	乳	ˏjy
宇	宇	ˏjy
汝	汝	ˏjy
禹	禹	ˏjy
與	与	ˏjy
阮	阮	ˏjyn
軟	软	ˏjyn
遠	远	ˏjyn
蕊	蕊	ˏjœy
氧	氧	ˏjœŋ
攘	攘	ˏjœŋ
仰	仰	ˏjœŋ
養	养	ˏjœŋ
癢	痒	ˏjœŋ
嚷	嚷	ˏjœŋ/_jœŋ
荏	荏	ˏjɐm/_jɐm
蚓	蚓	ˏjɐn
引	引	ˏjɐn
友	友	ˏjɐu
酉	酉	ˏjɐu
有	有	ˏjɐu
誘	诱	ˏjɐu
惹	惹	ˏjɛ
野	野	ˏjɛ
冶	冶	ˏjɛ
郢	郢	ˏjɪŋ
勇	勇	ˏjʊŋ
企	企	ˏkei
蹺	跷	ˏkiu
愧	愧	ˏkwɐi
拒	拒	ˏkœy
距	距	ˏkœy
強	强	ˏkœŋ
羥	羟	ˏkœŋ
妗	妗	ˏkɐm
近	近	ˏkɐn
臼	臼	ˏkɐu/¯kɐu
舅	舅	ˏkɐu/¯kɐu
攬	揽	ˏlam
欖	榄	ˏlam
覽	览	ˏlam
懶	懒	ˏlan
冷	冷	ˏlaŋ
娌	娌	ˏlei
理	理	ˏlei
邐	逦	ˏlei
鋰	锂	ˏlei
鯉	鲤	ˏlei
里	里	ˏlei
俚	俚	ˏlei
李	李	ˏlei
履	履	ˏlei
哩	哩	ˏlei/'jɪŋ/ˏlei
臉	脸	ˏlim
殮	殓	ˏlim
攆	撵	ˏlin
輦	辇	ˏlin
瞭	了	ˏliu
了	了	ˏliu
潦	潦	ˏliu/´liu
擄	掳	ˏlou
鹵	卤	ˏlou
魯	鲁	ˏlou
老	老	ˏlou
姥	姥	ˏlou
滷	卤	ˏlou
櫓	橹	ˏlou
虜	虏	ˏlou
鋁	铝	ˏlœy
磊	磊	ˏlœy
膂	膂	ˏlœy
儡	儡	ˏlœy
裡	里	ˏlœy
縷	缕	ˏlœy
累	累	ˏlœy
屢	屡	ˏlœy
呂	吕	ˏlœy
壘	垒	ˏlœy
旅	旅	ˏlœy
褸	褛	ˏlœy
侶	侣	ˏlœy
蕾	蕾	ˏlœy/ˌlœy
魎	魉	ˏlœŋ
兩	两	ˏlœŋ
倆	俩	ˏlœŋ
鱧	鳢	ˏlɐi
醴	醴	ˏlɐi
澧	澧	ˏlɐi
禮	礼	ˏlɐi
凜	凛	ˏlɐm
懍	懔	ˏlɐm
簍	篓	ˏlɐu
柳	柳	ˏlɐu
朗	朗	ˏlɔŋ
嶺	岭	ˏlɪŋ/ˏlɛŋ
領	领	ˏlɪŋ/ˏlɛŋ
隴	陇	ˏlʊŋ
壟	垄	ˏlʊŋ
籠	笼	ˏlʊŋ
攏	拢	ˏlʊŋ
瑪	玛	ˏma
碼	码	ˏma
獁	犸	ˏma
螞	蚂	ˏma
馬	马	ˏma
買	买	ˏmai
蕒	荬	ˏmai
晚	晚	ˏman
卯	卯	ˏmau
鉚	铆	ˏmau
錳	锰	ˏmaŋ
猛	猛	ˏmaŋ
蜢	蜢	ˏmaŋ
勐	勐	ˏmaŋ
美	美	ˏmei
鎂	镁	ˏmei
媺	媺	ˏmei
娓	娓	ˏmei
尾	尾	ˏmei
勉	勉	ˏmin
靦	腼	ˏmin
免	免	ˏmin
娩	娩	ˏmin
冕	冕	ˏmin
緬	缅	ˏmin
杳	杳	ˏmiu
渺	渺	ˏmiu
淼	淼	ˏmiu
藐	藐	ˏmiu
邈	邈	ˏmiu
秒	秒	ˏmiu
緲	缈	ˏmiu
姆	姆	ˏmou
侮	侮	ˏmou
武	武	ˏmou
舞	舞	ˏmou
拇	拇	ˏmou
母	母	ˏmou
鵡	鹉	ˏmou
嫵	妩	ˏmou
每	每	ˏmui
滿	满	ˏmun
蟎	螨	ˏmun
米	米	ˏmɐi
鰵	鳘	ˏmɐn
閩	闽	ˏmɐn
刎	刎	ˏmɐn
憫	悯	ˏmɐn
澠	渑	ˏmɐn
閔	闵	ˏmɐn
愍	愍	ˏmɐn
敏	敏	ˏmɐn
黽	黾	ˏmɐn
吻	吻	ˏmɐn
泯	泯	ˏmɐn
抿	抿	ˏmɐn
湣	湣	ˏmɐn
畝	亩	ˏmɐu
某	某	ˏmɐu
牡	牡	ˏmɐu
妄	妄	ˏmɔŋ
輞	辋	ˏmɔŋ
罔	罔	ˏmɔŋ
魍	魍	ˏmɔŋ
網	网	ˏmɔŋ
惘	惘	ˏmɔŋ
蟒	蟒	ˏmɔŋ
酩	酩	ˏmɪŋ
皿	皿	ˏmɪŋ
茗	茗	ˏmɪŋ/ˌmɪŋ
蠓	蠓	ˏmʊŋ
懵	懵	ˏmʊŋ/´mʊŋ
哪	哪	ˏna
那	那	ˏna
乃	乃	ˏnai
氖	氖	ˏnai
奶	奶	ˏnai
鼐	鼐	ˏnai
腩	腩	ˏnam
赧	赧	ˏnan
你	你	ˏnei
旎	旎	ˏnei
妳	你	ˏnei
您	您	ˏnei
碾	碾	ˏnin
裊	袅	ˏniu
鳥	鸟	ˏniu
腦	脑	ˏnou
瑙	瑙	ˏnou
惱	恼	ˏnou
弩	弩	ˏnou
努	努	ˏnou/ˏlou
暖	暖	ˏnyn
釹	钕	ˏnœy
餒	馁	ˏnœy
女	女	ˏnœy/ˏlœy
稔	稔	ˏnɐm
饢	馕	ˏnɔŋ
棒	棒	ˏpaŋ
婢	婢	ˏpei
被	被	ˏpei
鰾	鳔	ˏpiu
瞟	瞟	ˏpiu
抱	抱	ˏpou
泡	泡	ˏpou
倍	倍	ˏpui
蓓	蓓	ˏpui/ˌpui
睥	睥	ˏpɐi
牝	牝	ˏpɐn
蚌	蚌	ˏpɔŋ
市	市	ˏsi
鱔	鳝	ˏsin
雋	隽	ˏsyn
吮	吮	ˏsyn
墅	墅	ˏsœy
髓	髓	ˏsœy
緒	绪	ˏsœy
絮	絮	ˏsœy/_sœy
上	上	ˏsœŋ
舐	舐	ˏsɐi/´sɐi
腎	肾	ˏsɐn
社	社	ˏsɛ
淡	淡	ˏtam
殄	殄	ˏtin/ˏtim
窕	窕	ˏtiu
挑	挑	ˏtiu
肚	肚	ˏtou
恃	恃	ˏtsi
柿	柿	ˏtsi
似	似	ˏtsi
踐	践	ˏtsin/_dzin
曙	曙	ˏtsy
處	处	ˏtsy
署	署	ˏtsy
佇	伫	ˏtsy
褚	褚	ˏtsy
柱	柱	ˏtsy
苧	苎	ˏtsy
儲	储	ˏtsy
坐	坐	ˏtsɔ
重	重	ˏtsʊŋ
斷	断	ˏtyn
盾	盾	ˏtœn
挺	挺	ˏtɪŋ
鋌	铤	ˏtɪŋ
艇	艇	ˏtɪŋ/ˏtɛŋ
踝	踝	ˏwa
挽	挽	ˏwan
輓	挽	ˏwan
會	会	ˏwui
浣	浣	ˏwun
皖	皖	ˏwun
韋	韦	ˏwɐi
緯	纬	ˏwɐi
葦	苇	ˏwɐi
瑋	玮	ˏwɐi
諱	讳	ˏwɐi
韙	韪	ˏwɐi
偉	伟	ˏwɐi
殞	殒	ˏwɐn
尹	尹	ˏwɐn
狁	狁	ˏwɐn
隕	陨	ˏwɐn
允	允	ˏwɐn
往	往	ˏwɔŋ
永	永	ˏwɪŋ
雅	雅	ˏŋa
佤	佤	ˏŋa
瓦	瓦	ˏŋa
眼	眼	ˏŋan
咬	咬	ˏŋau
蟻	蚁	ˏŋɐi
藕	藕	ˏŋɐu
偶	偶	ˏŋɐu
我	我	ˏŋɔ
午	午	ˏŋ̩
忤	忤	ˏŋ̩
五	五	ˏŋ̩
牾	牾	ˏŋ̩
伍	伍	ˏŋ̩
