开放粤语字典（黄锡凌调符调号版）

© 2013年 kaifangcidian.com
网址：http://www.kaifangcidian.com
本字典以创作共用“署名 3.0”许可协议授权发布（详见 http://creativecommons.org/licenses/by/3.0/）
最后更新于2013年1月22日

［简体字］	［繁体字］	［黄锡凌拼音］

丫	丫	'a
呀	呀	'a
啊	啊	'a
锕	錒	'a
吖	吖	'a
鸦	鴉	'a
挨	挨	'ai
轭	軛	'ak
罂	罌	'aŋ
巴	巴	'ba
爸	爸	'ba
葩	葩	'ba
叭	叭	'ba
粑	粑	'ba
芭	芭	'ba
笆	笆	'ba
疤	疤	'ba
掰	掰	'bai/¯mak
迫	迫	'bak/'bik
班	班	'ban
瘢	瘢	'ban
颁	頒	'ban
斑	斑	'ban
包	包	'bau
褒	褒	'bau
苞	苞	'bau
胞	胞	'bau
鲍	鮑	'bau
孢	孢	'bau
裨	裨	'bei
卑	卑	'bei
悲	悲	'bei
屄	屄	'bei
碑	碑	'bei
逼	逼	'bik
愎	愎	'bik
璧	璧	'bik
壁	壁	'bik
碧	碧	'bik
辫	辮	'bin
鞭	鞭	'bin
边	邊	'bin
觱	觱	'bit
必	必	'bit
镳	鑣	'biu
标	標	'biu
表	錶	'biu
镖	鏢	'biu
彪	彪	'biu
膘	膘	'biu
飙	飆	'biu
晡	晡	'bou
杯	杯	'bui
搬	搬	'bun
般	般	'bun
跛	跛	'bɐi/´bɔ
北	北	'bɐk
泵	泵	'bɐm
乓	乓	'bɐm/'pɔŋ
滨	濱	'bɐn
彬	彬	'bɐn
斌	斌	'bɐn
槟	檳	'bɐn
缤	繽	'bɐn
宾	賓	'bɐn
奔	奔	'bɐn
濒	瀕	'bɐn/ˌpɐn
毕	畢	'bɐt
笔	筆	'bɐt
哔	嗶	'bɐt
筚	篳	'bɐt
不	不	'bɐt
钚	鈈	'bɐt
跸	蹕	'bɐt
荜	蓽	'bɐt
镚	鏰	'bɐŋ
崩	崩	'bɐŋ
菠	菠	'bɔ
玻	玻	'bɔ
波	波	'bɔ
帮	幫	'bɔŋ
邦	邦	'bɔŋ
梆	梆	'bɔŋ
啤	啤	'bɛ
冰	冰	'bɪŋ
兵	兵	'bɪŋ
乒	乒	'bɪŋ/'pɪŋ
卜	卜	'bʊk
呆	呆	'dai
儋	儋	'dam
担	擔	'dam
聃	聃	'dam
眈	眈	'dam
耽	耽	'dam
丹	丹	'dan
殚	殫	'dan
单	單	'dan
郸	鄲	'dan
的	的	'dik
滴	滴	'dik
嫡	嫡	'dik
掂	掂	'dim
颠	顛	'din
巅	巔	'din
碘	碘	'din
癫	癲	'din
丢	丟	'diu
刁	刁	'diu
碉	碉	'diu
凋	凋	'diu
雕	雕	'diu
鲷	鯛	'diu
叼	叼	'diu
貂	貂	'diu
都	都	'dou
嘟	嘟	'dou
叨	叨	'dou
刀	刀	'dou
端	端	'dyn
渣	渣	'dza
糌	糌	'dza
咱	咱	'dza
齇	齇	'dza
楂	楂	'dza
吒	吒	'dza
抓	抓	'dza/´dzau
赍	齎	'dzai
斋	齋	'dzai
嘲	嘲	'dzau
咨	咨	'dzi
兹	茲	'dzi
孜	孜	'dzi
滋	滋	'dzi
吱	吱	'dzi
氏	氏	'dzi
知	知	'dzi
支	支	'dzi
脂	脂	'dzi
蜘	蜘	'dzi
淄	淄	'dzi
辎	輜	'dzi
枝	枝	'dzi
肢	肢	'dzi
芝	芝	'dzi
龇	齜	'dzi
谘	諮	'dzi
鼒	鼒	'dzi
资	資	'dzi
赀	貲	'dzi
之	之	'dzi
姿	姿	'dzi
织	織	'dzik
迹	跡	'dzik
绩	績	'dzik
陟	陟	'dzik
积	積	'dzik
稷	稷	'dzik
鲫	鯽	'dzik
即	即	'dzik
职	職	'dzik
渍	漬	'dzik/¯dzi
占	占	'dzim
瞻	瞻	'dzim
沾	沾	'dzim
詹	詹	'dzim
尖	尖	'dzim
谵	譫	'dzim
霑	霑	'dzim
笺	箋	'dzin
毡	氈	'dzin
膻	羶	'dzin
煎	煎	'dzin
唧	唧	'dzit
朝	朝	'dziu
招	招	'dziu
礁	礁	'dziu
焦	焦	'dziu
椒	椒	'dziu
蕉	蕉	'dziu
糟	糟	'dzou
遭	遭	'dzou
租	租	'dzou
诛	誅	'dzy
铢	銖	'dzy
朱	朱	'dzy
诸	諸	'dzy
侏	侏	'dzy
茱	茱	'dzy
株	株	'dzy
猪	豬	'dzy
蛛	蛛	'dzy
珠	珠	'dzy
颛	顓	'dzyn
专	專	'dzyn
尊	尊	'dzyn
砖	磚	'dzyn
鳟	鱒	'dzyn/¯dzyn
镌	鐫	'dzyn/¯dzœn
榛	榛	'dzœn
臻	臻	'dzœn
津	津	'dzœn
樽	樽	'dzœn
谆	諄	'dzœn
遵	遵	'dzœn/'dzyn
卒	卒	'dzœt
怵	怵	'dzœt
黜	黜	'dzœt
追	追	'dzœy
椎	椎	'dzœy
锥	錐	'dzœy
狙	狙	'dzœy
蛆	蛆	'dzœy/'tsœy
章	章	'dzœŋ
浆	漿	'dzœŋ
漳	漳	'dzœŋ
嫜	嫜	'dzœŋ
獐	獐	'dzœŋ
张	張	'dzœŋ
彰	彰	'dzœŋ
樟	樟	'dzœŋ
璋	璋	'dzœŋ
蟑	蟑	'dzœŋ
将	將	'dzœŋ
鄣	鄣	'dzœŋ
齑	齏	'dzɐi
跻	躋	'dzɐi
挤	擠	'dzɐi
剂	劑	'dzɐi
仄	仄	'dzɐk
则	則	'dzɐk
昃	昃	'dzɐk
侧	側	'dzɐk
针	針	'dzɐm
箴	箴	'dzɐm
砧	砧	'dzɐm
斟	斟	'dzɐm
簪	簪	'dzɐm
胗	胗	'dzɐn
珍	珍	'dzɐn
真	真	'dzɐn
汁	汁	'dzɐp
执	執	'dzɐp
质	質	'dzɐt
洲	洲	'dzɐu
诌	謅	'dzɐu
周	周	'dzɐu
州	州	'dzɐu
舟	舟	'dzɐu
邹	鄒	'dzɐu
诹	諏	'dzɐu
辀	輈	'dzɐu
揪	揪	'dzɐu
周	週	'dzɐu
陬	陬	'dzɐu
憎	憎	'dzɐŋ
曾	曾	'dzɐŋ
筝	箏	'dzɐŋ
增	增	'dzɐŋ
峥	崢	'dzɐŋ
铮	錚	'dzɐŋ
僧	僧	'dzɐŋ
挣	掙	'dzɐŋ/'dzaŋ
争	爭	'dzɐŋ/'dzaŋ
狰	猙	'dzɐŋ/'dzaŋ
睁	睜	'dzɐŋ/'dzaŋ
灾	災	'dzɔi
栽	栽	'dzɔi
哉	哉	'dzɔi
妆	妝	'dzɔŋ
庄	莊	'dzɔŋ
装	裝	'dzɔŋ
脏	髒	'dzɔŋ
赃	贓	'dzɔŋ
桩	樁	'dzɔŋ
嗟	嗟	'dzɛ
遮	遮	'dzɛ
晶	晶	'dzɪŋ
蒸	蒸	'dzɪŋ
症	癥	'dzɪŋ
侦	偵	'dzɪŋ
烝	烝	'dzɪŋ
旌	旌	'dzɪŋ
睛	睛	'dzɪŋ
菁	菁	'dzɪŋ
精	精	'dzɪŋ
征	徵	'dzɪŋ
祯	禎	'dzɪŋ
征	征	'dzɪŋ
怔	怔	'dzɪŋ
贞	貞	'dzɪŋ
钲	鉦	'dzɪŋ
正	正	'dzɪŋ
足	足	'dzʊk
祝	祝	'dzʊk
粥	粥	'dzʊk
捉	捉	'dzʊk
瞩	矚	'dzʊk
烛	燭	'dzʊk
嘱	囑	'dzʊk
筑	築	'dzʊk
竹	竹	'dzʊk
竺	竺	'dzʊk
螽	螽	'dzʊŋ
鬃	鬃	'dzʊŋ
中	中	'dzʊŋ
忠	忠	'dzʊŋ
钟	鍾	'dzʊŋ
棕	棕	'dzʊŋ
宗	宗	'dzʊŋ
枞	樅	'dzʊŋ
钟	鐘	'dzʊŋ
踪	蹤	'dzʊŋ
盅	盅	'dzʊŋ
纵	縱	'dzʊŋ
终	終	'dzʊŋ
衷	衷	'dzʊŋ/'tsʊŋ
综	綜	'dzʊŋ/¯dzʊŋ
敦	敦	'dœn
惇	惇	'dœn
蹲	蹲	'dœn
墩	墩	'dœn
咄	咄	'dœt
堆	堆	'dœy
低	低	'dɐi
得	得	'dɐk
德	德	'dɐk
兜	兜	'dɐu
噔	噔	'dɐŋ
灯	燈	'dɐŋ
登	登	'dɐŋ
蹬	蹬	'dɐŋ
哆	哆	'dɔ
多	多	'dɔ
铛	鐺	'dɔŋ
裆	襠	'dɔŋ
当	噹	'dɔŋ
当	當	'dɔŋ
爹	爹	'dɛ
仃	仃	'dɪŋ
丁	丁	'dɪŋ
町	町	'dɪŋ
汀	汀	'dɪŋ
叮	叮	'dɪŋ/'dɛŋ
盯	盯	'dɪŋ/'dɛŋ
钉	釘	'dɪŋ/'dɛŋ
督	督	'dʊk
笃	篤	'dʊk
咚	咚	'dʊŋ
冬	冬	'dʊŋ
氡	氡	'dʊŋ
东	東	'dʊŋ
欸	欸	'ei
花	花	'fa
翻	翻	'fan
番	番	'fan
幡	幡	'fan
旛	旛	'fan
鲱	鯡	'fei
菲	菲	'fei
妃	妃	'fei
霏	霏	'fei
非	非	'fei
飞	飛	'fei
扉	扉	'fei
蜚	蜚	'fei
绯	緋	'fei
呼	呼	'fu
轷	軤	'fu
骷	骷	'fu
夫	夫	'fu
肤	膚	'fu
孵	孵	'fu
麸	麩	'fu
敷	敷	'fu
枯	枯	'fu
孚	孚	'fu
俘	俘	'fu
诙	詼	'fui
灰	灰	'fui
魁	魁	'fui
恢	恢	'fui
奎	奎	'fui/'kwɐi
宽	寬	'fun
欢	歡	'fun
髋	髖	'fun
獾	貛	'fun
挥	揮	'fɐi
撝	撝	'fɐi
晖	暉	'fɐi
徽	徽	'fɐi
辉	輝	'fɐi
纷	紛	'fɐn
婚	婚	'fɐn
薰	薰	'fɐn
氛	氛	'fɐn
勋	勳	'fɐn
吩	吩	'fɐn
芬	芬	'fɐn
酚	酚	'fɐn
昏	昏	'fɐn
荤	葷	'fɐn
分	分	'fɐn
熏	燻	'fɐn
熏	熏	'fɐn
醺	醺	'fɐn
佛	彿	'fɐt
惚	惚	'fɐt
笏	笏	'fɐt
氟	氟	'fɐt
窟	窟	'fɐt
囫	囫	'fɐt
忽	忽	'fɐt
弗	弗	'fɐt
拂	拂	'fɐt
科	科	'fɔ
蝌	蝌	'fɔ
邡	邡	'fɔŋ
坊	坊	'fɔŋ
谎	謊	'fɔŋ
慌	慌	'fɔŋ
肪	肪	'fɔŋ
方	方	'fɔŋ
荒	荒	'fɔŋ
芳	芳	'fɔŋ
啡	啡	'fɛ
辐	輻	'fʊk
复	複	'fʊk
腹	腹	'fʊk
覆	覆	'fʊk
福	福	'fʊk
幅	幅	'fʊk
馥	馥	'fʊk
蝠	蝠	'fʊk
蝮	蝮	'fʊk
风	風	'fʊŋ
封	封	'fʊŋ
蜂	蜂	'fʊŋ
锋	鋒	'fʊŋ
丰	豐	'fʊŋ
烽	烽	'fʊŋ
丰	丰	'fʊŋ
枫	楓	'fʊŋ
疯	瘋	'fʊŋ
峰	峰	'fʊŋ
伽	伽	'ga
袈	袈	'ga
枷	枷	'ga
家	家	'ga
家	傢	'ga
噶	噶	'ga
嘉	嘉	'ga
痂	痂	'ga
镓	鎵	'ga
加	加	'ga
迦	迦	'ga
珈	珈	'ga
佳	佳	'gai
偕	偕	'gai
街	街	'gai
阶	階	'gai
皆	皆	'gai
秸	秸	'gai
监	監	'gam
缄	緘	'gam
尴	尷	'gam/¯gam
奸	姦	'gan
艰	艱	'gan
间	間	'gan
奸	奸	'gan
跤	跤	'gau
蛟	蛟	'gau
交	交	'gau
郊	郊	'gau
茭	茭	'gau
胶	膠	'gau
耕	耕	'gaŋ
更	更	'gaŋ
矶	磯	'gei
乩	乩	'gei
箕	箕	'gei
奇	奇	'gei
几	幾	'gei
机	機	'gei
肌	肌	'gei
基	基	'gei
玑	璣	'gei
畿	畿	'gei
几	几	'gei
羁	覊	'gei
讥	譏	'gei
畸	畸	'gei
姬	姬	'gei
饥	飢	'gei
犄	犄	'gei
叽	嘰	'gei
戟	戟	'gik
击	擊	'gik
棘	棘	'gik
亟	亟	'gik
殛	殛	'gik
激	激	'gik
鹣	鶼	'gim
搛	搛	'gim
兼	兼	'gim
坚	堅	'gin
犍	犍	'gin
肩	肩	'gin
娇	嬌	'giu
骄	驕	'giu
羔	羔	'gou
膏	膏	'gou
糕	糕	'gou
皋	皋	'gou
高	高	'gou
睾	睾	'gou
姑	姑	'gu
沽	沽	'gu
蛄	蛄	'gu
轱	軲	'gu
咕	咕	'gu
孤	孤	'gu
辜	辜	'gu
觚	觚	'gu
菇	菇	'gu
冠	冠	'gun
官	官	'gun
棺	棺	'gun
倌	倌	'gun
莞	莞	'gun
观	觀	'gun
瓜	瓜	'gwa
呱	呱	'gwa
乖	乖	'gwai
关	關	'gwan
鳏	鰥	'gwan
虢	虢	'gwik
隙	隙	'gwik/'kwɪŋ
龟	龜	'gwɐi
瑰	瑰	'gwɐi
鲑	鮭	'gwɐi
皈	皈	'gwɐi
硅	硅	'gwɐi
圭	圭	'gwɐi
归	歸	'gwɐi
闺	閨	'gwɐi
均	均	'gwɐn
军	軍	'gwɐn
纶	綸	'gwɐn
君	君	'gwɐn
筠	筠	'gwɐn
鋆	鋆	'gwɐn
锟	錕	'gwɐn
鲲	鯤	'gwɐn
钧	鈞	'gwɐn
橘	橘	'gwɐt
骨	骨	'gwɐt
轰	轟	'gwɐŋ
訇	訇	'gwɐŋ
薨	薨	'gwɐŋ
肱	肱	'gwɐŋ
戈	戈	'gwɔ
桄	桄	'gwɔŋ
光	光	'gwɔŋ
胱	胱	'gwɔŋ
娟	娟	'gyn
捐	捐	'gyn
鹃	鵑	'gyn
蠲	蠲	'gyn
涓	涓	'gyn
据	据	'gœy
居	居	'gœy
僵	僵	'gœŋ
疆	疆	'gœŋ
缰	韁	'gœŋ
姜	薑	'gœŋ
姜	姜	'gœŋ
蜣	蜣	'gœŋ
僵	殭	'gœŋ
羌	羌	'gœŋ
鸡	雞	'gɐi
今	今	'gɐm
柑	柑	'gɐm
苷	苷	'gɐm
甘	甘	'gɐm
泔	泔	'gɐm
金	金	'gɐm
禁	禁	'gɐm
哏	哏	'gɐn
筋	筋	'gɐn
跟	跟	'gɐn
根	根	'gɐn
巾	巾	'gɐn
斤	斤	'gɐn
急	急	'gɐp
讫	訖	'gɐt
桔	桔	'gɐt
纥	紇	'gɐt
吉	吉	'gɐt
佝	佝	'gɐu
阄	鬮	'gɐu
钩	鉤	'gɐu
鸠	鳩	'gɐu/'kɐu
庚	庚	'gɐŋ
更	更	'gɐŋ
羹	羹	'gɐŋ
哥	哥	'gɔ
仡	仡	'gɔ
歌	歌	'gɔ
旮	旮	'gɔ/¯gɔk
菏	菏	'gɔ/ˌhɔ
赅	賅	'gɔi
该	該	'gɔi
咯	咯	'gɔk
杆	杆	'gɔn
干	乾	'gɔn
干	干	'gɔn
竿	竿	'gɔn
肝	肝	'gɔn
岗	崗	'gɔŋ
肛	肛	'gɔŋ
罡	罡	'gɔŋ
缸	缸	'gɔŋ
刚	剛	'gɔŋ
江	江	'gɔŋ
纲	綱	'gɔŋ
冈	岡	'gɔŋ
惊	驚	'gɛŋ
京	京	'gɪŋ
惊	驚	'gɪŋ
经	經	'gɪŋ
泾	涇	'gɪŋ
兢	兢	'gɪŋ
荆	荊	'gɪŋ
矜	矜	'gɪŋ
谷	谷	'gʊk
毂	轂	'gʊk
谷	穀	'gʊk
鞠	鞠	'gʊk
梏	梏	'gʊk
嚳	嚳	'gʊk
菊	菊	'gʊk
鹄	鵠	'gʊk
掬	掬	'gʊk
宫	宮	'gʊŋ
攻	攻	'gʊŋ
工	工	'gʊŋ
功	功	'gʊŋ
公	公	'gʊŋ
躬	躬	'gʊŋ
龚	龔	'gʊŋ
蚣	蚣	'gʊŋ
弓	弓	'gʊŋ
供	供	'gʊŋ
恭	恭	'gʊŋ
哈	哈	'ha
虾	蝦	'ha
揩	揩	'hai
嗨	嗨	'hai
赫	赫	'hak
哮	哮	'hau
敲	敲	'hau
烤	烤	'hau/´hau
夯	夯	'haŋ
坑	坑	'haŋ
熙	熙	'hei
嬉	嬉	'hei
醯	醯	'hei
浠	浠	'hei
熹	熹	'hei
欺	欺	'hei
羲	羲	'hei
唏	唏	'hei
嘻	嘻	'hei
希	希	'hei
稀	稀	'hei
欷	欷	'hei
禧	禧	'hei
牺	犧	'hei
嘿	嘿	'hei
烯	烯	'hei
曦	曦	'hei
谦	謙	'him
掀	掀	'hin
牵	牽	'hin
轩	軒	'hin
骞	騫	'hin
嚣	囂	'hiu
枭	梟	'hiu
骁	驍	'hiu
鸮	鴞	'hiu
侥	僥	'hiu
浇	澆	'hiu
橇	橇	'hiu/¯tsœy
蒿	蒿	'hou
薅	薅	'hou
埙	壎	'hyn
萱	萱	'hyn
圈	圈	'hyn
暄	暄	'hyn
喧	喧	'hyn
吁	吁	'hœy
墟	墟	'hœy
歔	歔	'hœy
嘘	噓	'hœy
盱	盱	'hœy
虚	虛	'hœy
乡	鄉	'hœŋ
香	香	'hœŋ
氪	氪	'hɐk
可	可	'hɐk
克	克	'hɐk
刻	刻	'hɐk
黑	黑	'hɐk
克	剋	'hɐk
堪	堪	'hɐm
戡	戡	'hɐm
憨	憨	'hɐm
勘	勘	'hɐm
蚶	蚶	'hɐm
龛	龕	'hɐm
洽	洽	'hɐp
恰	恰	'hɐp
乞	乞	'hɐt
齁	齁	'hɐu
亨	亨	'hɐŋ
哼	哼	'hɐŋ
铿	鏗	'hɐŋ
茎	莖	'hɐŋ/¯gɪŋ
诃	訶	'hɔ
苛	苛	'hɔ
呵	呵	'hɔ
开	開	'hɔi
锎	鐦	'hɔi
咍	咍	'hɔi
腔	腔	'hɔŋ
糠	糠	'hɔŋ
诓	誆	'hɔŋ
匡	匡	'hɔŋ
劻	劻	'hɔŋ
康	康	'hɔŋ
筐	筐	'hɔŋ/'kwaŋ
眶	眶	'hɔŋ/'kwaŋ
靴	靴	'hɛu
馨	馨	'hɪŋ
卿	卿	'hɪŋ
氢	氫	'hɪŋ
兄	兄	'hɪŋ
兴	興	'hɪŋ
轻	輕	'hɪŋ/'hɛŋ
哭	哭	'hʊk
凶	凶	'hʊŋ
汹	洶	'hʊŋ
崆	崆	'hʊŋ
凶	兇	'hʊŋ
匈	匈	'hʊŋ
箜	箜	'hʊŋ
空	空	'hʊŋ
胸	胸	'hʊŋ
衣	衣	'ji
医	醫	'ji
依	依	'ji
伊	伊	'ji
铱	銥	'ji
祎	禕	'ji
祎	禕	'ji
猗	猗	'ji
漪	漪	'ji
黟	黟	'ji
益	益	'jik
阋	鬩	'jik
忆	憶	'jik
臆	臆	'jik
抑	抑	'jik
亿	億	'jik
淹	淹	'jim
奄	奄	'jim
阉	閹	'jim
恹	懨	'jim
腌	醃	'jim/¯jip
鄢	鄢	'jin
阏	閼	'jin
蔫	蔫	'jin
烟	菸	'jin
嫣	嫣	'jin
燕	燕	'jin
咽	咽	'jin
湮	湮	'jin
焉	焉	'jin
胭	胭	'jin
烟	煙	'jin
妖	妖	'jiu
腰	腰	'jiu
夭	夭	'jiu
邀	邀	'jiu
幺	么	'jiu
吆	吆	'jiu
要	要	'jiu
淤	淤	'jy
迂	迂	'jy
于	於	'jy
渊	淵	'jyn
鸳	鴛	'jyn
鸢	鳶	'jyn
冤	冤	'jyn
蜿	蜿	'jyn
央	央	'jœŋ
殃	殃	'jœŋ
秧	秧	'jœŋ
鸯	鴦	'jœŋ
音	音	'jɐm
钦	欽	'jɐm
鑫	鑫	'jɐm
阴	陰	'jɐm
歆	歆	'jɐm
氤	氤	'jɐn
因	因	'jɐn
堙	堙	'jɐn
甄	甄	'jɐn
忻	忻	'jɐn
殷	殷	'jɐn
姻	姻	'jɐn
欣	欣	'jɐn
昕	昕	'jɐn
茵	茵	'jɐn
恩	恩	'jɐn
邑	邑	'jɐp
挹	挹	'jɐp
翕	翕	'jɐp
熠	熠	'jɐp
泣	泣	'jɐp
揖	揖	'jɐp
悒	悒	'jɐp
壹	壹	'jɐt
一	一	'jɐt
咻	咻	'jɐu
休	休	'jɐu
幽	幽	'jɐu
忧	憂	'jɐu
丘	丘	'jɐu
鸺	鵂	'jɐu
邱	邱	'jɐu
优	優	'jɐu
貅	貅	'jɐu
蚯	蚯	'jɐu
髹	髹	'jɐu
哟	喲	'jɔ
唷	唷	'jɔ
膺	膺	'jɪŋ
鹰	鷹	'jɪŋ
瑛	瑛	'jɪŋ
鹦	鸚	'jɪŋ
缨	纓	'jɪŋ
樱	櫻	'jɪŋ
英	英	'jɪŋ
婴	嬰	'jɪŋ
应	應	'jɪŋ
郁	郁	'jʊk
煜	煜	'jʊk
顼	頊	'jʊk
毓	毓	'jʊk
彧	彧	'jʊk
昱	昱	'jʊk
沃	沃	'jʊk
旭	旭	'jʊk
雍	雍	'jʊŋ
翁	翁	'jʊŋ
嗡	嗡	'jʊŋ
饔	饔	'jʊŋ
廱	廱	'jʊŋ
邕	邕	'jʊŋ
卡	卡	'ka
喀	喀	'ka
蹊	蹊	'kei
崎	崎	'kei
跷	蹺	'kiu/'hiu
箍	箍	'ku
夸	誇	'kwa
垮	垮	'kwa
夸	夸	'kwa
框	框	'kwaŋ/'hɔŋ
盔	盔	'kwɐi
亏	虧	'kwɐi
岿	巋	'kwɐi
规	規	'kwɐi
窥	窺	'kwɐi
昆	崑	'kwɐn
坤	坤	'kwɐn
髡	髡	'kwɐn
昆	昆	'kwɐn
焜	焜	'kwɐn/_wɐn
岖	嶇	'kœy
祛	祛	'kœy
驹	駒	'kœy
俱	俱	'kœy
躯	軀	'kœy
驱	驅	'kœy
区	區	'kœy
拘	拘	'kœy
蹊	蹊	'kɐi
稽	稽	'kɐi
溪	溪	'kɐi
嵇	嵇	'kɐi/ˌhɐi
襟	襟	'kɐm
吸	吸	'kɐp
给	給	'kɐp
岌	岌	'kɐp
级	級	'kɐp
笈	笈	'kɐp
歙	歙	'kɐp
汲	汲	'kɐp
咳	咳	'kɐt
卡	卡	'kɐt
抠	摳	'kɐu
篝	篝	'kɐu/'gɐu
沟	溝	'kɐu/'gɐu
扛	扛	'kɔŋ
倾	傾	'kɪŋ
曲	曲	'kʊk
曲	麴	'kʊk
拉	拉	'la
啦	啦	'la
喇	喇	'la
拉	拉	'lai
喱	喱	'lei
璃	璃	'lei
哩	哩	'li
枥	櫪	'lik
砾	礫	'lik
雳	靂	'lik
沥	瀝	'lik/_lik
令	令	'lim
撂	撂	'liu
撩	撩	'liu
溜	溜	'liu
捞	撈	'lou
噜	嚕	'lou
笠	笠	'lɐp
甩	甩	'lɐt
喽	嘍	'lɐu
囉	囉	'lɔ
咯	咯	'lɔ
旯	旯	'lɔ/¯lɔk
啷	啷	'lɔŋ
哩	哩	'lɛ
咧	咧	'lɛ
辘	轆	'lʊk
麓	麓	'lʊk
碌	碌	'lʊk
嬷	嬤	'ma
妈	媽	'ma
吗	嗎	'ma/¯ma
猫	貓	'mau
绷	繃	'maŋ
喵	喵	'miu
咪	咪	'mɐi/'mei
蚊	蚊	'mɐn
哞	哞	'mɐu
摩	摩	'mɔ
么	麼	'mɔ
魔	魔	'mɔ
剥	剝	'mɔk
哶	哶	'mɛ
哪	哪	'na
孬	孬	'nau
匿	匿	'nik
昵	暱	'nik
溺	溺	'nik/_nik
拈	拈	'nim
粘	粘	'nim/'dzim
黏	黏	'nim/'dzim
镍	鎳	'nip
粒	粒	'nɐp/'lɐp
呢	呢	'nɛ
趴	趴	'pa
啪	啪	'pak
攀	攀	'pan
扳	扳	'pan
泡	泡	'pau
脬	脬	'pau
抛	拋	'pau
澎	澎	'paŋ
烹	烹	'paŋ
披	披	'pei
狉	狉	'pei
丕	丕	'pei
呸	呸	'pei
纰	紕	'pei
辟	闢	'pik
僻	僻	'pik
霹	霹	'pik
辟	辟	'pik
癖	癖	'pik
编	編	'pin
偏	偏	'pin
翩	翩	'pin
篇	篇	'pin
扁	扁	'pin
蝙	蝙	'pin/'bin
漂	漂	'piu
飘	飄	'piu
缥	縹	'piu
嘌	嘌	'piu
铺	鋪	'pou
坯	坯	'pui
胚	胚	'pui
番	番	'pun
潘	潘	'pun
批	批	'pɐi
疋	疋	'pɐt
匹	匹	'pɐt
颇	頗	'pɔ
坡	坡	'pɔ/'bɔ
棵	棵	'pɔ/´fɔ
怦	怦	'pɪŋ
抨	抨	'pɪŋ
姘	姘	'pɪŋ
砰	砰	'pɪŋ
娉	娉	'pɪŋ
拼	拼	'pɪŋ/¯pɪŋ
仆	仆	'pʊk
莎	莎	'sa
卅	卅	'sa
裟	裟	'sa
纱	紗	'sa
砂	砂	'sa
沙	沙	'sa
痧	痧	'sa
啥	啥	'sa
鲨	鯊	'sa
仨	仨	'sam
三	三	'sam
叁	叄	'sam
衫	衫	'sam
山	山	'san
栓	栓	'san
珊	珊	'san
舢	舢	'san
闩	閂	'san
姗	姍	'san
删	刪	'san
潸	潸	'san
拴	拴	'san
跚	跚	'san
梢	梢	'sau
捎	捎	'sau
牲	牲	'saŋ
甥	甥	'saŋ
尸	尸	'si
丝	絲	'si
师	師	'si
诗	詩	'si
厮	廝	'si
尸	屍	'si
思	思	'si
司	司	'si
私	私	'si
施	施	'si
斯	斯	'si
蓍	蓍	'si
撕	撕	'si
狮	獅	'si
饰	飾	'sik
淅	淅	'sik
蟋	蟋	'sik
悉	悉	'sik
螫	螫	'sik
皙	皙	'sik
晰	晰	'sik
识	識	'sik
惜	惜	'sik
铯	銫	'sik
式	式	'sik
析	析	'sik
昔	昔	'sik
轼	軾	'sik
熄	熄	'sik
色	色	'sik
适	適	'sik
媳	媳	'sik
啬	嗇	'sik
息	息	'sik
释	釋	'sik
蜥	蜥	'sik
拭	拭	'sik
鲜	鮮	'sin
先	先	'sin
酰	酰	'sin
仙	仙	'sin
氙	氙	'sin/'san
宵	宵	'siu
霄	霄	'siu
消	消	'siu
潇	瀟	'siu
魈	魈	'siu
箫	簫	'siu
逍	逍	'siu
硝	硝	'siu
萧	蕭	'siu
韶	韶	'siu
烧	燒	'siu
销	銷	'siu
稣	穌	'sou
苏	囌	'sou
臊	臊	'sou
骚	騷	'sou
搔	搔	'sou
须	鬚	'sou
酥	酥	'sou
苏	蘇	'sou
甦	甦	'sou
书	書	'sy
舒	舒	'sy
纾	紓	'sy
抒	抒	'sy
输	輸	'sy
枢	樞	'sy
瑄	瑄	'syn
孙	孫	'syn
狲	猻	'syn
宣	宣	'syn
酸	酸	'syn
狻	狻	'syn
荪	蓀	'syn
悛	悛	'syn
飧	飧	'syn
荀	荀	'sœn
芯	芯	'sœn
殉	殉	'sœn
询	詢	'sœn
峋	峋	'sœn
率	率	'sœt
戌	戌	'sœt
恤	恤	'sœt
摔	摔	'sœt
蟀	蟀	'sœt
衰	衰	'sœy
濉	濉	'sœy
绥	綏	'sœy
需	需	'sœy
胥	胥	'sœy
荽	荽	'sœy
须	須	'sœy
虽	雖	'sœy
睢	睢	'sœy
伤	傷	'sœŋ
殇	殤	'sœŋ
孀	孀	'sœŋ
觞	觴	'sœŋ
湘	湘	'sœŋ
箱	箱	'sœŋ
商	商	'sœŋ
厢	廂	'sœŋ
双	雙	'sœŋ
霜	霜	'sœŋ
襄	襄	'sœŋ
相	相	'sœŋ
镶	鑲	'sœŋ
鹴	鸘	'sœŋ
嘶	嘶	'sɐi
硒	硒	'sɐi
舾	舾	'sɐi
犀	犀	'sɐi
西	西	'sɐi
筛	篩	'sɐi
塞	塞	'sɐk
噻	噻	'sɐk
参	參	'sɐm
森	森	'sɐm
心	心	'sɐm
琛	琛	'sɐm
深	深	'sɐm
芯	芯	'sɐm
郴	郴	'sɐm
身	身	'sɐn
燊	燊	'sɐn
薪	薪	'sɐn
新	新	'sɐn
砷	砷	'sɐn
伸	伸	'sɐn
申	申	'sɐn
呻	呻	'sɐn
锌	鋅	'sɐn
娠	娠	'sɐn
辛	辛	'sɐn
莘	莘	'sɐn
绅	紳	'sɐn
湿	濕	'sɐp
涩	澀	'sɐp/'sik/¯gip
膝	膝	'sɐt
瑟	瑟	'sɐt
失	失	'sɐt
室	室	'sɐt
虱	蝨	'sɐt
螋	螋	'sɐu
飕	颼	'sɐu
羞	羞	'sɐu
嗖	嗖	'sɐu
馊	餿	'sɐu
收	收	'sɐu
修	修	'sɐu
搜	搜	'sɐu/´sɐu
笙	笙	'sɐŋ
生	生	'sɐŋ/'saŋ
唆	唆	'sɔ
疏	疏	'sɔ
蓑	蓑	'sɔ
蔬	蔬	'sɔ
嗦	嗦	'sɔ
羧	羧	'sɔ
梭	梭	'sɔ
梳	梳	'sɔ
鳃	鰓	'sɔi
腮	腮	'sɔi
桑	桑	'sɔŋ
丧	喪	'sɔŋ
些	些	'sɛ
星	星	'sɪŋ
惺	惺	'sɪŋ
升	陞	'sɪŋ
胜	勝	'sɪŋ
升	升	'sɪŋ
升	昇	'sɪŋ
猩	猩	'sɪŋ
声	聲	'sɪŋ/'sɛŋ
腥	腥	'sɪŋ/'sɛŋ
粟	粟	'sʊk
僳	僳	'sʊk
倏	倏	'sʊk
鹔	鷫	'sʊk
宿	宿	'sʊk
叔	叔	'sʊk
夙	夙	'sʊk
缩	縮	'sʊk
蓿	蓿	'sʊk
肃	肅	'sʊk
淞	淞	'sʊŋ
松	鬆	'sʊŋ
忪	忪	'sʊŋ
从	從	'sʊŋ
嵩	嵩	'sʊŋ
它	它	'ta
他	祂	'ta
他	他	'ta
她	她	'ta
它	牠	'ta
铊	鉈	'ta
贪	貪	'tam
坍	坍	'tan
瘫	癱	'tan
摊	攤	'tan
滩	灘	'tan
铽	鋱	'tik
忑	忑	'tik
惕	惕	'tik
倜	倜	'tik
忒	忒	'tik
剔	剔	'tik
添	添	'tim
天	天	'tin
挑	挑	'tiu
叨	叨	'tou
饕	饕	'tou
韬	韜	'tou
滔	滔	'tou
叉	叉	'tsa
差	差	'tsa
揣	揣	'tsai
搋	搋	'tsai
猜	猜	'tsai
钗	釵	'tsai
差	差	'tsai
参	參	'tsam
掺	摻	'tsam
搀	攙	'tsam
餐	餐	'tsan
钞	鈔	'tsau
抄	抄	'tsau
瞠	瞠	'tsaŋ
撑	撐	'tsaŋ
蚩	蚩	'tsi
差	差	'tsi
哧	哧	'tsi
眵	眵	'tsi
螭	螭	'tsi
疵	疵	'tsi
痴	癡	'tsi
跐	跐	'tsi
嗤	嗤	'tsi
笞	笞	'tsi
鸱	鴟	'tsi
魑	魑	'tsi
雌	雌	'tsi
彳	彳	'tsik
敕	敕	'tsik
叱	叱	'tsik
戚	戚	'tsik
斥	斥	'tsik
签	籤	'tsim
纤	纖	'tsim
签	簽	'tsim
歼	殲	'tsim
迁	遷	'tsin
阡	阡	'tsin
仟	仟	'tsin
千	韆	'tsin
千	千	'tsin
超	超	'tsiu
锹	鍬	'tsiu
昭	昭	'tsiu
钊	釗	'tsiu
粗	粗	'tsou
操	操	'tsou
躇	躇	'tsy
橱	櫥	'tsy
汆	汆	'tsyn
穿	穿	'tsyn
村	村	'tsyn
川	川	'tsyn
蹿	躥	'tsyn
春	春	'tsœn
出	齣	'tsœt
出	出	'tsœt
催	催	'tsœy
趋	趨	'tsœy
吹	吹	'tsœy
摧	摧	'tsœy
崔	崔	'tsœy
炊	炊	'tsœy
璀	璀	'tsœy/´tsœy
猖	猖	'tsœŋ
伥	倀	'tsœŋ
锵	鏘	'tsœŋ
菖	菖	'tsœŋ
娼	娼	'tsœŋ
枪	槍	'tsœŋ
鲳	鯧	'tsœŋ
戗	戧	'tsœŋ
呛	嗆	'tsœŋ
昌	昌	'tsœŋ
窗	窗	'tsœŋ
栖	棲	'tsɐi
悽	悽	'tsɐi
妻	妻	'tsɐi
凄	淒	'tsɐi
测	測	'tsɐk
恻	惻	'tsɐk
侵	侵	'tsɐm
参	參	'tsɐm/'tsam
瞋	瞋	'tsɐn
亲	親	'tsɐn
嗔	嗔	'tsɐn
葺	葺	'tsɐp
缉	緝	'tsɐp
辑	輯	'tsɐp
柒	柒	'tsɐt
漆	漆	'tsɐt
七	七	'tsɐt
秋	秋	'tsɐu
抽	抽	'tsɐu
秋	鞦	'tsɐu
鳅	鰍	'tsɐu
楸	楸	'tsɐu
磋	磋	'tsɔ
搓	搓	'tsɔ
刍	芻	'tsɔ
雏	雛	'tsɔ
初	初	'tsɔ
仓	倉	'tsɔŋ
沧	滄	'tsɔŋ
创	創	'tsɔŋ
伧	傖	'tsɔŋ
苍	蒼	'tsɔŋ
疮	瘡	'tsɔŋ
舱	艙	'tsɔŋ
车	車	'tsɛ
奢	奢	'tsɛ
称	稱	'tsɪŋ
清	清	'tsɪŋ
氰	氰	'tsɪŋ
蛏	蟶	'tsɪŋ
蜻	蜻	'tsɪŋ
鲭	鯖	'tsɪŋ
青	青	'tsɪŋ/'tsɛŋ
簇	簇	'tsʊk
亍	亍	'tsʊk
龊	齪	'tsʊk
蹴	蹴	'tsʊk
簌	簌	'tsʊk
畜	畜	'tsʊk
蹙	蹙	'tsʊk
矗	矗	'tsʊk
束	束	'tsʊk
搐	搐	'tsʊk
蓄	蓄	'tsʊk
促	促	'tsʊk
速	速	'tsʊk
触	觸	'tsʊk/'dzʊk
充	充	'tsʊŋ
憧	憧	'tsʊŋ
涌	涌	'tsʊŋ
囱	囪	'tsʊŋ
冲	沖	'tsʊŋ
葱	蔥	'tsʊŋ
骢	驄	'tsʊŋ
匆	匆	'tsʊŋ
枞	樅	'tsʊŋ
忡	忡	'tsʊŋ
聪	聰	'tsʊŋ
冲	衝	'tsʊŋ
湍	湍	'tœn/'dzyn
推	推	'tœy
锑	銻	'tɐi
梯	梯	'tɐi
吞	吞	'tɐn
饨	飩	'tɐn
偷	偷	'tɐu
拖	拖	'tɔ
苔	苔	'tɔi
胎	胎	'tɔi
汤	湯	'tɔŋ
汀	汀	'tɪŋ
烃	烴	'tɪŋ
听	聽	'tɪŋ/'tɛŋ
厅	廳	'tɪŋ/'tɛŋ
秃	禿	'tʊk
通	通	'tʊŋ
洼	窪	'wa
娃	娃	'wa
蛙	蛙	'wa
哇	哇	'wa
哗	嘩	'wa
哗	譁	'wa
凹	凹	'wa
歪	歪	'wai
湾	灣	'wan
弯	彎	'wan
钨	鎢	'wu
污	污	'wu
邬	鄔	'wu
乌	烏	'wu
呜	嗚	'wu
恶	惡	'wu
偎	偎	'wui
剜	剜	'wun
威	威	'wɐi
葳	葳	'wɐi
委	委	'wɐi
逶	逶	'wɐi
崴	崴	'wɐi
氲	氳	'wɐn
温	溫	'wɐn
瘟	瘟	'wɐn
屈	屈	'wɐt
郁	鬱	'wɐt
蜗	蝸	'wɔ
娲	媧	'wɔ
涡	渦	'wɔ
窝	窩	'wɔ
挝	撾	'wɔ
莴	萵	'wɔ
锅	鍋	'wɔ
倭	倭	'wɔ
窠	窠	'wɔ/'fɔ
汪	汪	'wɔŋ
扔	扔	'wɪŋ
勾	勾	'ŋɐu
肮	骯	'ŋɔŋ/¯ŋɔŋ
哎	哎	'ɐi
唉	唉	'ɐi
龌	齷	'ɐk/'ak
扼	扼	'ɐk/'ak
幄	幄	'ɐk/'ak
厄	厄	'ɐk/'ak
渥	渥	'ɐk/'ak
握	握	'ɐk/'ak
谙	諳	'ɐm
庵	庵	'ɐm
鹌	鵪	'ɐm
瓯	甌	'ɐu
欧	歐	'ɐu
鸥	鷗	'ɐu
莺	鶯	'ɐŋ
罂	罌	'ɐŋ
珂	珂	'ɔ
轲	軻	'ɔ
喔	喔	'ɔ
柯	柯	'ɔ
婀	婀	'ɔ
噢	噢	'ɔ
阿	阿	'ɔ
哀	哀	'ɔi
埃	埃	'ɔi
安	安	'ɔn
铵	銨	'ɔn
氨	氨	'ɔn
胺	胺	'ɔn
鞍	鞍	'ɔn
桉	桉	'ɔn
屋	屋	'ʊk
罢	罷	_ba
吧	吧	_ba
稗	稗	_bai
败	敗	_bai
白	白	_bak
卜	蔔	_bak
匐	匐	_bak
帛	帛	_bak
扮	扮	_ban
办	辦	_ban
茇	茇	_bat
龅	齙	_bau
鲍	鮑	_bau
蹦	蹦	_baŋ
绷	繃	_baŋ
箆	箆	_bei
备	備	_bei
鼻	鼻	_bei
避	避	_bei
被	被	_bei
惫	憊	_bei/_bai
辨	辨	_bin
辩	辯	_bin
便	便	_bin
卞	卞	_bin
别	別	_bit
蹩	蹩	_bit
瘪	癟	_bit
步	步	_bou
部	部	_bou
簿	簿	_bou
捕	捕	_bou
暴	暴	_bou
哺	哺	_bou
埠	埠	_bou/_fɐu
焙	焙	_bui
悖	悖	_bui
背	背	_bui
拌	拌	_bun
畔	畔	_bun
叛	叛	_bun
绊	絆	_bun
胖	胖	_bun
伴	伴	_bun/´pun
脖	脖	_but
拨	撥	_but
勃	勃	_but
荸	荸	_but
渤	渤	_but
弊	弊	_bɐi
陛	陛	_bɐi
毙	斃	_bɐi
狴	狴	_bɐi
币	幣	_bɐi
敝	敝	_bɐi
笨	笨	_bɐn
苾	苾	_bɐt
拔	拔	_bɐt
跋	跋	_bɐt
弼	弼	_bɐt
钹	鈸	_bɐt
菝	菝	_bɐt
薄	薄	_bɔk
礴	礴	_bɔk
箔	箔	_bɔk
泊	泊	_bɔk
铂	鉑	_bɔk
雹	雹	_bɔk
舶	舶	_bɔk/¯pak
磅	磅	_bɔŋ
镑	鎊	_bɔŋ
傍	傍	_bɔŋ
呗	唄	_bɛ
病	病	_bɛŋ/_bɪŋ
并	並	_bɪŋ
蹼	蹼	_bʊk
濮	濮	_bʊk
瀑	瀑	_bʊk
仆	僕	_bʊk
曝	曝	_bʊk
大	大	_dai
澹	澹	_dam
淡	淡	_dam
氮	氮	_dam
淡	淡	_dam/ˏtam
蛋	蛋	_dan
疍	疍	_dan
弹	彈	_dan
惮	憚	_dan
但	但	_dan
蹋	蹋	_dap
沓	沓	_dap
踏	踏	_dap
哒	噠	_dat
达	達	_dat
繨	繨	_dat
地	地	_dei
涤	滌	_dik
翟	翟	_dik
狄	狄	_dik
迪	迪	_dik
敌	敵	_dik
奠	奠	_din
佃	佃	_din
电	電	_din
淀	澱	_din
垫	墊	_din
殿	殿	_din
靛	靛	_din
甸	甸	_din
叠	疊	_dip
碟	碟	_dip
喋	喋	_dip
牒	牒	_dip
谍	諜	_dip
鲽	鰈	_dip
蝶	蝶	_dip
耋	耋	_dit
秩	秩	_dit
迭	迭	_dit
掉	掉	_diu
调	調	_diu
稻	稻	_dou
蹈	蹈	_dou
杜	杜	_dou
镀	鍍	_dou
道	道	_dou
悼	悼	_dou
渡	渡	_dou
导	導	_dou
度	度	_dou
盗	盜	_dou
缎	緞	_dyn
段	段	_dyn
断	斷	_dyn
断	斷	_dyn/¯dyn
夺	奪	_dyt
膪	膪	_dza
嵖	嵖	_dza
眦	眥	_dzai
寨	寨	_dzai
谪	謫	_dzak
宅	宅	_dzak
择	擇	_dzak
泽	澤	_dzak
摘	摘	_dzak
掷	擲	_dzak
踯	躑	_dzak
暂	暫	_dzam
站	站	_dzam
錾	鏨	_dzam
栈	棧	_dzan
绽	綻	_dzan
馔	饌	_dzan
赚	賺	_dzan
撰	撰	_dzan
袭	襲	_dzap
闸	閘	_dzap
集	集	_dzap
习	習	_dzap
隰	隰	_dzap
什	什	_dzap
杂	雜	_dzap
挣	掙	_dzaŋ
祀	祀	_dzi
字	字	_dzi
稚	稚	_dzi
痔	痔	_dzi
饲	飼	_dzi
嗣	嗣	_dzi
自	自	_dzi
治	治	_dzi
巳	巳	_dzi
雉	雉	_dzi
伺	伺	_dzi
耜	耜	_dzi
俟	俟	_dzi
豸	豸	_dzi/_dzai
寺	寺	_dzi/´dzi
峙	峙	_dzi/ˏtsi
籍	籍	_dzik
矽	矽	_dzik
寂	寂	_dzik
直	直	_dzik
汐	汐	_dzik
殖	殖	_dzik
植	植	_dzik
席	席	_dzik
值	值	_dzik
夕	夕	_dzik
藉	藉	_dzik
蓆	蓆	_dzik/_dzɛk
借	藉	_dzik/¯dzɛ
借	借	_dzik/¯dzɛ
渐	漸	_dzim
贱	賤	_dzin
捷	捷	_dzit
睫	睫	_dzit
截	截	_dzit
召	召	_dziu
赵	趙	_dziu
造	造	_dzou
皂	皂	_dzou
做	做	_dzou
慥	慥	_dzou/¯tsou
住	住	_dzy
箸	箸	_dzy
传	傳	_dzyn
绝	絕	_dzyt
著	著	_dzœk
着	著	_dzœk
尽	盡	_dzœn
烬	燼	_dzœn
屿	嶼	_dzœy
序	序	_dzœy
溆	漵	_dzœy
罪	罪	_dzœy
聚	聚	_dzœy
叙	敘	_dzœy
坠	墜	_dzœy
缀	綴	_dzœy/¯dzœy
丈	丈	_dzœŋ
像	像	_dzœŋ
象	象	_dzœŋ
仗	仗	_dzœŋ
匠	匠	_dzœŋ
杖	杖	_dzœŋ
橡	橡	_dzœŋ
滞	滯	_dzɐi
朕	朕	_dzɐm
鸩	鴆	_dzɐm
阵	陣	_dzɐn
蛭	蛭	_dzɐt
桎	桎	_dzɐt
侄	姪	_dzɐt
疾	疾	_dzɐt
蛰	蟄	_dzɐt
嫉	嫉	_dzɐt
窒	窒	_dzɐt
鹫	鷲	_dzɐu
冑	冑	_dzɐu
袖	袖	_dzɐu
就	就	_dzɐu
纣	紂	_dzɐu
宙	宙	_dzɐu
岫	岫	_dzɐu
骤	驟	_dzɐu
赠	贈	_dzɐŋ
唑	唑	_dzɔ
坐	坐	_dzɔ
座	座	_dzɔ
助	助	_dzɔ
在	在	_dzɔi
擢	擢	_dzɔk
凿	鑿	_dzɔk
脏	臟	_dzɔŋ
奘	奘	_dzɔŋ
藏	藏	_dzɔŋ
状	狀	_dzɔŋ
撞	撞	_dzɔŋ
谢	謝	_dzɛ
郑	鄭	_dzɛŋ/_dzɪŋ
净	淨	_dzɪŋ
靖	靖	_dzɪŋ
静	靜	_dzɪŋ
阱	阱	_dzɪŋ/_dzɛŋ
浊	濁	_dzʊk
续	續	_dzʊk
妯	妯	_dzʊk
镯	鐲	_dzʊk
轴	軸	_dzʊk
俗	俗	_dzʊk
镞	鏃	_dzʊk
族	族	_dzʊk
逐	逐	_dzʊk
躅	躅	_dzʊk
重	重	_dzʊŋ
颂	頌	_dzʊŋ
仲	仲	_dzʊŋ
诵	誦	_dzʊŋ
讼	訟	_dzʊŋ
盹	盹	_dœn
钝	鈍	_dœn
顿	頓	_dœn
沌	沌	_dœn
遁	遁	_dœn
吨	噸	_dœn
兑	兌	_dœy
队	隊	_dœy
第	第	_dɐi
递	遞	_dɐi
弟	弟	_dɐi
悌	悌	_dɐi
棣	棣	_dɐi
隶	隸	_dɐi
逮	逮	_dɐi/_dɔi
特	特	_dɐk
炖	燉	_dɐn
突	突	_dɐt
凸	凸	_dɐt
逗	逗	_dɐu
痘	痘	_dɐu
窦	竇	_dɐu
豆	豆	_dɐu/´dɐu
邓	鄧	_dɐŋ
瞪	瞪	_dɐŋ/'dɐŋ
堕	墮	_dɔ
驮	馱	_dɔ
惰	惰	_dɔ
岱	岱	_dɔi
玳	玳	_dɔi
待	待	_dɔi
袋	袋	_dɔi
甙	甙	_dɔi
代	代	_dɔi
黛	黛	_dɔi
叇	靆	_dɔi
殆	殆	_dɔi/ˏtɔi
怠	怠	_dɔi/ˏtɔi
踱	踱	_dɔk
铎	鐸	_dɔk
度	度	_dɔk
菪	菪	_dɔŋ
砀	碭	_dɔŋ
荡	盪	_dɔŋ
荡	蕩	_dɔŋ
宕	宕	_dɔŋ
笛	笛	_dɛk
籴	糴	_dɛk
啶	啶	_dɪŋ
定	定	_dɪŋ
毒	毒	_dʊk
碡	碡	_dʊk
独	獨	_dʊk
读	讀	_dʊk
渎	瀆	_dʊk
黩	黷	_dʊk
椟	櫝	_dʊk
牍	牘	_dʊk
髑	髑	_dʊk
犊	犢	_dʊk
侗	侗	_dʊŋ
动	動	_dʊŋ
胴	胴	_dʊŋ
恸	慟	_dʊŋ
洞	洞	_dʊŋ
恫	恫	_dʊŋ
欸	欸	_ei
范	范	_fan
犯	犯	_fan
范	範	_fan
瓣	瓣	_fan
饭	飯	_fan
驸	駙	_fu
鲋	鮒	_fu
讣	訃	_fu
父	父	_fu
辅	輔	_fu
傅	傅	_fu
付	付	_fu
腐	腐	_fu
赴	赴	_fu
负	負	_fu
仆	仆	_fu
咐	咐	_fu
附	附	_fu
吠	吠	_fɐi
份	份	_fɐn
分	分	_fɐn
筏	筏	_fɐt
佛	佛	_fɐt
罚	罰	_fɐt
阀	閥	_fɐt
伐	伐	_fɐt
乏	乏	_fɐt
阜	阜	_fɐu
宓	宓	_fʊk
茯	茯	_fʊk
伏	伏	_fʊk
袱	袱	_fʊk
复	復	_fʊk
服	服	_fʊk
凤	鳳	_fʊŋ
奉	奉	_fʊŋ
俸	俸	_fʊŋ/´fʊŋ
妓	妓	_gei
伎	伎	_gei
忌	忌	_gei
技	技	_gei
芰	芰	_gei
极	極	_gik
俭	儉	_gim
件	件	_gin
键	鍵	_gin
健	健	_gin
杰	傑	_git
桀	桀	_git
轿	轎	_giu
撬	撬	_giu
诰	誥	_gou
篑	簣	_gwɐi
跪	跪	_gwɐi
馈	饋	_gwɐi
柜	櫃	_gwɐi
珺	珺	_gwɐn
郡	郡	_gwɐn
倔	倔	_gwɐt
崛	崛	_gwɐt
掘	掘	_gwɐt
倦	倦	_gyn
巨	鉅	_gœy
苣	苣	_gœy
巨	巨	_gœy
炬	炬	_gœy
飓	颶	_gœy
惧	懼	_gœy
讵	詎	_gœy
遽	遽	_gœy
具	具	_gœy
强	強	_gœŋ
近	近	_gɐn
疙	疙	_gɐt
旧	舊	_gɐu
痉	痙	_gɪŋ
劲	勁	_gɪŋ
竞	競	_gɪŋ
局	局	_gʊk
焗	焗	_gʊk
锔	鋦	_gʊk
共	共	_gʊŋ
下	下	_ha
夏	夏	_ha
厦	廈	_ha
暇	暇	_ha
械	械	_hai
懈	懈	_hai
解	解	_hai
邂	邂	_hai/ˏhai
馅	餡	_ham
陷	陷	_ham
限	限	_han
箧	篋	_hap
峡	峽	_hap
柙	柙	_hap
狎	狎	_hap
匣	匣	_hap
侠	俠	_hap/_hɐp
狭	狹	_hap/¯hap
傚	傚	_hau
效	效	_hau
校	校	_hau
効	効	_hau
惬	愜	_hip
灏	灝	_hou
昊	昊	_hou
号	號	_hou
浩	浩	_hou
皓	皓	_hou
镐	鎬	_hou
哼	哼	_hŋ̩
系	繫	_hɐi
系	係	_hɐi
系	系	_hɐi
憾	憾	_hɐm
撼	撼	_hɐm
恨	恨	_hɐn
阖	闔	_hɐp
盒	盒	_hɐp
合	合	_hɐp
磕	磕	_hɐp
瞌	瞌	_hɐp
颌	頜	_hɐp
辖	轄	_hɐt
阂	閡	_hɐt
劾	劾	_hɐt
檄	檄	_hɐt
龁	齕	_hɐt
纥	紇	_hɐt
瞎	瞎	_hɐt
核	核	_hɐt/_wɐt
候	候	_hɐu
后	後	_hɐu
鲎	鱟	_hɐu
逅	逅	_hɐu
后	后	_hɐu
幸	幸	_hɐŋ
杏	杏	_hɐŋ
悻	悻	_hɐŋ
幸	倖	_hɐŋ
行	行	_hɐŋ
荷	荷	_hɔ
贺	賀	_hɔ
氦	氦	_hɔi
害	害	_hɔi
亥	亥	_hɔi
鹤	鶴	_hɔk
学	學	_hɔk
貉	貉	_hɔk
捍	捍	_hɔn
翰	翰	_hɔn
焊	焊	_hɔn
悍	悍	_hɔn
汗	汗	_hɔn
瀚	瀚	_hɔn
项	項	_hɔŋ
巷	巷	_hɔŋ/´hɔŋ
槲	槲	_hʊk
酷	酷	_hʊk
劓	劓	_ji
义	義	_ji
二	二	_ji
易	易	_ji
肄	肄	_ji
异	異	_ji
贰	貳	_ji
亦	亦	_jik
译	譯	_jik
绎	繹	_jik
奕	奕	_jik
驿	驛	_jik
役	役	_jik
翊	翊	_jik
液	液	_jik
弈	弈	_jik
蜴	蜴	_jik
腋	腋	_jik
疫	疫	_jik
翼	翼	_jik
翌	翌	_jik
掖	掖	_jik
弋	弋	_jik
易	易	_jik
逆	逆	_jik/_ŋak
验	驗	_jim
焰	焰	_jim
艳	艷	_jim
唁	唁	_jin
砚	硯	_jin
苋	莧	_jin
现	現	_jin
彦	彥	_jin
谚	諺	_jin
谳	讞	_jin
业	業	_jip
烨	燁	_jip
页	頁	_jip
叶	葉	_jip
热	熱	_jit
拽	拽	_jit
孽	孽	_jit
臬	臬	_jit/_nip
耀	耀	_jiu
鹞	鷂	_jiu
曜	曜	_jiu
豫	豫	_jy
语	語	_jy
裕	裕	_jy
寓	寓	_jy
御	御	_jy
与	與	_jy
誉	譽	_jy
蓣	蕷	_jy
御	禦	_jy
愈	愈	_jy
驭	馭	_jy
喻	喻	_jy
谕	諭	_jy
吁	籲	_jy
遇	遇	_jy
预	預	_jy
愈	癒	_jy
愿	願	_jyn
院	院	_jyn
县	縣	_jyn
媛	媛	_jyn
炫	炫	_jyn/ˌjyn
远	遠	_jyn/ˏjyn
悦	悅	_jyt
越	越	_jyt
粤	粵	_jyt
曰	曰	_jyt
阅	閱	_jyt
钇	釔	_jyt
穴	穴	_jyt
钺	鉞	_jyt
月	月	_jyt
乙	乙	_jyt/¯jyt
虐	虐	_jœk
钥	鑰	_jœk
药	藥	_jœk
龠	龠	_jœk
籥	籥	_jœk
弱	弱	_jœk
蒻	蒻	_jœk
疟	瘧	_jœk
若	若	_jœk
跃	躍	_jœk
谑	謔	_jœk
润	潤	_jœn
闰	閏	_jœn
芮	芮	_jœy
睿	睿	_jœy
裔	裔	_jœy
锐	銳	_jœy
恙	恙	_jœŋ
漾	漾	_jœŋ
让	讓	_jœŋ
样	樣	_jœŋ
壤	壤	_jœŋ
酿	釀	_jœŋ
曳	曳	_jɐi
跩	跩	_jɐi
赁	賃	_jɐm
衽	衽	_jɐm
妊	妊	_jɐm
饪	飪	_jɐm
任	任	_jɐm
任	任	_jɐm
胤	胤	_jɐn
纫	紉	_jɐn
衅	釁	_jɐn
刃	刃	_jɐn
孕	孕	_jɐn
韧	韌	_jɐn/_ŋɐŋ
入	入	_jɐp
轶	軼	_jɐt
溢	溢	_jɐt
逸	逸	_jɐt
日	日	_jɐt
囿	囿	_jɐu
又	又	_jɐu
宥	宥	_jɐu
釉	釉	_jɐu
侑	侑	_jɐu
佑	佑	_jɐu
右	右	_jɐu
鼬	鼬	_jɐu
狖	狖	_jɐu
夜	夜	_jɛ
偌	偌	_jɛ
认	認	_jɪŋ
育	育	_jʊk
玉	玉	_jʊk
缛	縟	_jʊk
欲	慾	_jʊk
欲	欲	_jʊk
肉	肉	_jʊk
褥	褥	_jʊk
钰	鈺	_jʊk
狱	獄	_jʊk
蓐	蓐	_jʊk
辱	辱	_jʊk
浴	浴	_jʊk
鬻	鬻	_jʊk
峪	峪	_jʊk/_jy
用	用	_jʊŋ
噱	噱	_kœk
及	及	_kɐp
芨	芨	_kɐp/'gɐp
屐	屐	_kɛk
剧	劇	_kɛk
落	落	_lai
籁	籟	_lai
赖	賴	_lai
滥	濫	_lam
舰	艦	_lam
缆	纜	_lam
烂	爛	_lan
蜡	蠟	_lap
立	立	_lap
垃	垃	_lap
砬	砬	_lap
腊	臘	_lap
邋	邋	_lap/_lat
拉	拉	_lat
辣	辣	_lat
痢	痢	_lei
吏	吏	_lei
猁	猁	_lei
利	利	_lei
莉	莉	_lei
俐	俐	_lei
莅	蒞	_lei
力	力	_lik
历	曆	_lik
历	歷	_lik
敛	斂	_lim
裣	襝	_lim
炼	煉	_lin
练	練	_lin
鬣	鬣	_lip
猎	獵	_lip
捩	捩	_lit
冽	冽	_lit
裂	裂	_lit
列	列	_lit
烈	烈	_lit
料	料	_liu
尥	尥	_liu
廖	廖	_liu
辂	輅	_lou
鹭	鷺	_lou
璐	璐	_lou
路	路	_lou
露	露	_lou
涝	澇	_lou
潞	潞	_lou
赂	賂	_lou
劳	勞	_lou
嫪	嫪	_lou
乱	亂	_lyn
掠	掠	_lœk
略	略	_lœk
吝	吝	_lœn
蔺	藺	_lœn
躏	躪	_lœn
论	論	_lœn
率	率	_lœt
律	律	_lœt
鹬	鷸	_lœt
溧	溧	_lœt
篥	篥	_lœt
傈	傈	_lœt
栗	栗	_lœt
栗	慄	_lœt
滤	濾	_lœy
类	類	_lœy
泪	淚	_lœy
虑	慮	_lœy
戾	戾	_lœy
累	累	_lœy
漯	漯	_lœy
辆	輛	_lœŋ
谅	諒	_lœŋ
踉	踉	_lœŋ
亮	亮	_lœŋ
量	量	_lœŋ
荔	荔	_lɐi
砺	礪	_lɐi
蛎	蠣	_lɐi
丽	麗	_lɐi
厉	厲	_lɐi
俪	儷	_lɐi
励	勵	_lɐi
例	例	_lɐi
肋	肋	_lɐk/_lak
鳓	鰳	_lɐk/_lak
勒	勒	_lɐk/_lak
陋	陋	_lɐu
蹓	蹓	_lɐu
镂	鏤	_lɐu
遛	遛	_lɐu
馏	餾	_lɐu
漏	漏	_lɐu
溜	溜	_lɐu
睐	睞	_lɔi
赉	賚	_lɔi
耒	耒	_lɔi/_lœy
乐	樂	_lɔk
落	落	_lɔk
蒗	蒗	_lɔŋ
晾	晾	_lɔŋ
浪	浪	_lɔŋ
阆	閬	_lɔŋ/ˌlɔŋ
令	令	_lɪŋ
另	另	_lɪŋ
愣	愣	_lɪŋ
陆	陸	_lʊk
鹿	鹿	_lʊk
漉	漉	_lʊk
碌	碌	_lʊk
戮	戮	_lʊk
禄	祿	_lʊk
氯	氯	_lʊk
录	錄	_lʊk
绿	綠	_lʊk
六	六	_lʊk
弄	弄	_lʊŋ
骂	罵	_ma
迈	邁	_mai
卖	賣	_mai
镘	鏝	_man
谩	謾	_man
嫚	嫚	_man
万	萬	_man
慢	慢	_man
蔓	蔓	_man
缦	縵	_man
曼	曼	_man
熳	熳	_man
漫	漫	_man
幔	幔	_man
墁	墁	_man
懋	懋	_mau
貌	貌	_mau
袤	袤	_mau
孟	孟	_maŋ
味	味	_mei
寐	寐	_mei
媚	媚	_mei
魅	魅	_mei
未	未	_mei
觅	覓	_mik
汨	汨	_mik
幂	冪	_mik
鼏	鼏	_mik
面	面	_min
面	麵	_min
蔑	衊	_mit
灭	滅	_mit
蔑	蔑	_mit
篾	篾	_mit
庙	廟	_miu
妙	妙	_miu
雾	霧	_mou
务	務	_mou
帽	帽	_mou
慕	慕	_mou
募	募	_mou
墓	墓	_mou
瑁	瑁	_mou
戊	戊	_mou
婺	婺	_mou
暮	暮	_mou
鹜	鶩	_mou
耄	耄	_mou
骛	騖	_mou
冒	冒	_mou
昧	昧	_mui
妹	妹	_mui
闷	悶	_mun
焖	燜	_mun
殁	歿	_mut
末	末	_mut
没	沒	_mut
靺	靺	_mut
茉	茉	_mut
袂	袂	_mɐi
陌	陌	_mɐk
万	万	_mɐk
墨	墨	_mɐk
默	默	_mɐk
貘	貘	_mɐk
蓦	驀	_mɐk
麦	麥	_mɐk
脉	脈	_mɐk
汶	汶	_mɐn
紊	紊	_mɐn
问	問	_mɐn
宓	宓	_mɐt
嘧	嘧	_mɐt
密	密	_mɐt
勿	勿	_mɐt
蜜	蜜	_mɐt
物	物	_mɐt
袜	襪	_mɐt
谧	謐	_mɐt
贸	貿	_mɐu
谬	謬	_mɐu
茂	茂	_mɐu
漠	漠	_mɔk
寞	寞	_mɔk
莫	莫	_mɔk
膜	膜	_mɔk
幕	幕	_mɔk
望	望	_mɔŋ
命	命	_mɛŋ
命	命	_mɪŋ
沐	沐	_mʊk
睦	睦	_mʊk
牧	牧	_mʊk
穆	穆	_mʊk
仫	仫	_mʊk
木	木	_mʊk
钼	鉬	_mʊk
目	目	_mʊk
苜	苜	_mʊk
梦	夢	_mʊŋ
难	難	_nan
钠	鈉	_nap
纳	納	_nap
衲	衲	_nap
呐	吶	_nap
捺	捺	_nat
淖	淖	_nau
闹	鬧	_nau
腻	膩	_nei
饵	餌	_nei
廿	廿	_nim
念	念	_nim
念	唸	_nim
镊	鑷	_nip
涅	涅	_nip
颞	顳	_nip
蹑	躡	_nip
捏	捏	_nip
陧	隉	_nip
聂	聶	_nip
尿	尿	_niu
溺	溺	_niu
怒	怒	_nou
嫩	嫩	_nyn
讷	訥	_nœt/_nap
懦	懦	_nɔ
糯	糯	_nɔ
奈	奈	_nɔi
内	內	_nɔi
耐	耐	_nɔi
诺	諾	_nɔk
齉	齉	_nɔŋ
佞	佞	_nɪŋ
泞	濘	_nɪŋ
拧	擰	_nɪŋ
忸	忸	_nʊk/´nɐu
伺	伺	_si
视	視	_si
是	是	_si
侍	侍	_si
士	士	_si
事	事	_si
示	示	_si
仕	仕	_si
豉	豉	_si
氏	氏	_si
蚀	蝕	_sik
食	食	_sik
赡	贍	_sim
掸	撣	_sin
善	善	_sin
禅	禪	_sin
鄯	鄯	_sin
单	單	_sin
嬗	嬗	_sin
羡	羨	_sin
擅	擅	_sin
缮	繕	_sin
倩	倩	_sin
膳	膳	_sin
茜	茜	_sin/'sɐi
绍	紹	_siu
肇	肇	_siu
劭	劭	_siu
邵	邵	_siu
兆	兆	_siu
树	樹	_sy
竖	豎	_sy
篆	篆	_syn
顺	順	_sœn
沭	沭	_sœt
述	述	_sœt
术	術	_sœt
粹	粹	_sœy
祟	祟	_sœy
悴	悴	_sœy
遂	遂	_sœy
睡	睡	_sœy
燧	燧	_sœy
邃	邃	_sœy
萃	萃	_sœy
穗	穗	_sœy
瑞	瑞	_sœy
隧	隧	_sœy
瘁	瘁	_sœy/ˏsœy
尚	尚	_sœŋ
上	上	_sœŋ
誓	誓	_sɐi
噬	噬	_sɐi
逝	逝	_sɐi
筮	筮	_sɐi
葚	椹	_sɐm
什	什	_sɐm
甚	甚	_sɐm
慎	慎	_sɐn
蜃	蜃	_sɐn/ˏsɐn
拾	拾	_sɐp
十	十	_sɐp
实	實	_sɐt
绶	綬	_sɐu
授	授	_sɐu
受	受	_sɐu
寿	壽	_sɐu
售	售	_sɐu
射	射	_sɛ
麝	麝	_sɛ
硕	碩	_sɛk
石	石	_sɛk
盛	盛	_sɪŋ
剩	剩	_sɪŋ
嵊	嵊	_sɪŋ
赎	贖	_sʊk
淑	淑	_sʊk
属	屬	_sʊk
塾	塾	_sʊk
孰	孰	_sʊk
蜀	蜀	_sʊk
熟	熟	_sʊk
菽	菽	_sʊk
鲗	鰂	_tsak
贼	賊	_tsak
锃	鋥	_tsaŋ
华	華	_wa
话	話	_wa
桦	樺	_wa/ˌwa
坏	壞	_wai
惑	惑	_wak
划	劃	_wak
画	畫	_wak
或	或	_wak
幻	幻	_wan
宦	宦	_wan
患	患	_wan
滑	滑	_wat
猾	猾	_wat
横	橫	_waŋ
蜮	蜮	_wik
阈	閾	_wik
域	域	_wik
扈	扈	_wu
芋	芋	_wu
互	互	_wu
户	戶	_wu
沪	滬	_wu
护	護	_wu
怙	怙	_wu
祜	祜	_wu
瓠	瓠	_wu/ˌwu
会	會	_wui
汇	匯	_wui
烩	燴	_wui
汇	彙	_wui/_wɐi
会	會	_wui/´wui
奂	奐	_wun
缓	緩	_wun
玩	玩	_wun
焕	煥	_wun
换	換	_wun
唤	喚	_wun
痪	瘓	_wun
活	活	_wut
彗	彗	_wɐi
慧	慧	_wɐi
卫	衛	_wɐi
为	為	_wɐi
猬	蝟	_wɐi
胃	胃	_wɐi
渭	渭	_wɐi
蕙	蕙	_wɐi
谓	謂	_wɐi
惠	惠	_wɐi
位	位	_wɐi
混	混	_wɐn
运	運	_wɐn
诨	諢	_wɐn
郓	鄆	_wɐn
晕	暈	_wɐn
熨	熨	_wɐn
韵	韻	_wɐn/ˏwɐn
鹬	鷸	_wɐt
聿	聿	_wɐt/_lœt
祸	禍	_wɔ
获	穫	_wɔk
镬	鑊	_wɔk
获	獲	_wɔk
旺	旺	_wɔŋ
颍	潁	_wɪŋ
颖	穎	_wɪŋ
泳	泳	_wɪŋ
咏	詠	_wɪŋ
讶	訝	_ŋa
刈	刈	_ŋai
艾	艾	_ŋai
砹	砹	_ŋai
额	額	_ŋak
雁	雁	_ŋan
赝	贗	_ŋan
硬	硬	_ŋaŋ
啮	齧	_ŋit/_ŋat
傲	傲	_ŋou
艺	藝	_ŋɐi
呓	囈	_ŋɐi
睨	睨	_ŋɐi
毅	毅	_ŋɐi
伪	偽	_ŋɐi
魏	魏	_ŋɐi
羿	羿	_ŋɐi
诣	詣	_ŋɐi
兀	兀	_ŋɐt
屹	屹	_ŋɐt
杌	杌	_ŋɐt
圪	圪	_ŋɐt
迄	迄	_ŋɐt
卧	臥	_ŋɔ
饿	餓	_ŋɔ
外	外	_ŋɔi
碍	礙	_ŋɔi
噩	噩	_ŋɔk
颚	顎	_ŋɔk
岳	岳	_ŋɔk
乐	樂	_ŋɔk
鳄	鱷	_ŋɔk
鄂	鄂	_ŋɔk
岳	嶽	_ŋɔk
愕	愕	_ŋɔk
犴	犴	_ŋɔn
岸	岸	_ŋɔn
捂	摀	_ŋ̩
悟	悟	_ŋ̩
焐	焐	_ŋ̩
嗯	嗯	_ŋ̩
误	誤	_ŋ̩
晤	晤	_ŋ̩
哦	哦	_ɔ
氩	氬	¯a
亚	亞	¯a
啊	啊	¯a
阿	阿	¯a
娅	婭	¯a
隘	隘	¯ai
晏	晏	¯an
鸭	鴨	¯ap
押	押	¯at
遏	遏	¯at
压	壓	¯at
轧	軋	¯at
猰	猰	¯at
揠	揠	¯at
拗	拗	¯au
坳	坳	¯au/'au
霸	霸	¯ba
坝	壩	¯ba
拜	拜	¯bai
伯	伯	¯bak
百	百	¯bak
佰	佰	¯bak
扮	扮	¯ban
八	八	¯bat
捌	捌	¯bat
爆	爆	¯bau
臂	臂	¯bei
痹	痺	¯bei
秘	秘	¯bei
辔	轡	¯bei
泌	泌	¯bei
铋	鉍	¯bei
庇	庇	¯bei
变	變	¯bin
别	彆	¯bit
鳖	鱉	¯bit
憋	憋	¯bit
埔	埔	¯bou
布	布	¯bou
怖	怖	¯bou
报	報	¯bou
布	佈	¯bou
背	揹	¯bui
狈	狽	¯bui
辈	輩	¯bui
钡	鋇	¯bui
贝	貝	¯bui
半	半	¯bun
钵	缽	¯but
赑	贔	¯bɐi
蔽	蔽	¯bɐi
闭	閉	¯bɐi
摈	擯	¯bɐn
鬓	鬢	¯bɐn
殡	殯	¯bɐn
播	播	¯bɔ
簸	簸	¯bɔ
亳	亳	¯bɔk
膊	膊	¯bɔk
驳	駁	¯bɔk
博	博	¯bɔk
搏	搏	¯bɔk
缚	縛	¯bɔk/¯fɔk
柄	柄	¯bɛŋ/¯bɪŋ
迸	迸	¯bɪŋ
并	併	¯bɪŋ/¯pɪŋ
甭	甭	¯bʊŋ
带	帶	¯dai
戴	戴	¯dai
诞	誕	¯dan
旦	旦	¯dan
耷	耷	¯dap
搭	搭	¯dap
答	答	¯dap
瘩	瘩	¯dap
靼	靼	¯dat
妲	妲	¯dat/´tan
店	店	¯dim
踮	踮	¯dim
玷	玷	¯dim
惦	惦	¯dim
垫	墊	¯din
跌	跌	¯dit
吊	吊	¯diu
吊	弔	¯diu
钓	釣	¯diu
到	到	¯dou
妒	妒	¯dou
倒	倒	¯dou
蠹	蠹	¯dou
锻	鍛	¯dyn
煅	煅	¯dyn
诈	詐	¯dza
咤	咤	¯dza
榨	榨	¯dza
咋	咋	¯dza
乍	乍	¯dza
炸	炸	¯dza
蚱	蚱	¯dza/¯dzak
债	債	¯dzai
责	責	¯dzak
啧	嘖	¯dzak
窄	窄	¯dzak
湛	湛	¯dzam
蘸	蘸	¯dzam
赞	贊	¯dzan
赞	讚	¯dzan
咂	咂	¯dzap
匝	匝	¯dzap
砸	砸	¯dzap
眨	眨	¯dzap
扎	扎	¯dzat
轧	軋	¯dzat
铡	鍘	¯dzat
札	札	¯dzat
拶	拶	¯dzat
紮	紮	¯dzat
罩	罩	¯dzau
置	置	¯dzi
致	致	¯dzi
致	緻	¯dzi
志	誌	¯dzi
轾	輊	¯dzi
志	志	¯dzi
挚	摯	¯dzi
智	智	¯dzi
痣	痣	¯dzi
踬	躓	¯dzi
质	質	¯dzi
至	至	¯dzi
恣	恣	¯dzi/¯tsi
瘠	瘠	¯dzik
脊	脊	¯dzik/¯dzɛk
炙	炙	¯dzik/¯dzɛk
占	佔	¯dzim
饯	餞	¯dzin
战	戰	¯dzin
颤	顫	¯dzin
箭	箭	¯dzin
荐	薦	¯dzin
溅	濺	¯dzin
接	接	¯dzip
辄	輒	¯dzip
浃	浹	¯dzip
嗫	囁	¯dzip
折	摺	¯dzip
褶	褶	¯dzip
楫	楫	¯dzip
哲	哲	¯dzit
栉	櫛	¯dzit
蜇	蜇	¯dzit
婕	婕	¯dzit
折	折	¯dzit
浙	浙	¯dzit
节	節	¯dzit
疖	癤	¯dzit
照	照	¯dziu
诏	詔	¯dziu
灶	灶	¯dzou
注	注	¯dzy
炷	炷	¯dzy
驻	駐	¯dzy
著	著	¯dzy
注	註	¯dzy
著	著	¯dzy
蛀	蛀	¯dzy
钻	鑽	¯dzyn
转	轉	¯dzyn
钻	鑽	¯dzyn/'dzyn
拙	拙	¯dzyt
啜	啜	¯dzyt
掇	掇	¯dzyt
茁	茁	¯dzyt
辍	輟	¯dzyt
咄	咄	¯dzyt
嚼	嚼	¯dzœk
着	著	¯dzœk
灼	灼	¯dzœk
雀	雀	¯dzœk
鹊	鵲	¯dzœk
斫	斫	¯dzœk
酌	酌	¯dzœk
爵	爵	¯dzœk
桌	桌	¯dzœk/¯tsœk
勺	勺	¯dzœk/¯tsœk
俊	俊	¯dzœn
进	進	¯dzœn
竣	竣	¯dzœn
晋	晉	¯dzœn
缙	縉	¯dzœn
峻	峻	¯dzœn
骏	駿	¯dzœn
惴	惴	¯dzœy
赘	贅	¯dzœy
最	最	¯dzœy
醉	醉	¯dzœy
障	障	¯dzœŋ
仗	仗	¯dzœŋ
帐	帳	¯dzœŋ
瘴	瘴	¯dzœŋ
嶂	嶂	¯dzœŋ
将	將	¯dzœŋ
账	賬	¯dzœŋ
酱	醬	¯dzœŋ
涨	漲	¯dzœŋ
幛	幛	¯dzœŋ
胀	脹	¯dzœŋ
祭	祭	¯dzɐi
霁	霽	¯dzɐi
制	製	¯dzɐi
制	制	¯dzɐi
掣	掣	¯dzɐi
际	際	¯dzɐi
济	濟	¯dzɐi
枕	枕	¯dzɐm
浸	浸	¯dzɐm
震	震	¯dzɐn
圳	圳	¯dzɐn
赈	賑	¯dzɐn
振	振	¯dzɐn
镇	鎮	¯dzɐn
昼	晝	¯dzɐu
奏	奏	¯dzɐu
皱	皺	¯dzɐu
咒	咒	¯dzɐu
揍	揍	¯dzɐu
绉	縐	¯dzɐu
佐	佐	¯dzɔ
诅	詛	¯dzɔ/´dzɔ
载	載	¯dzɔi
再	再	¯dzɔi
作	作	¯dzɔk
昨	昨	¯dzɔk/_dzɔk
壮	壯	¯dzɔŋ
葬	葬	¯dzɔŋ
戆	戇	¯dzɔŋ/_ŋɔŋ
蔗	蔗	¯dzɛ
柘	柘	¯dzɛ
借	借	¯dzɛ
只	隻	¯dzɛk
证	證	¯dzɪŋ
症	症	¯dzɪŋ
政	政	¯dzɪŋ
正	正	¯dzɪŋ
纵	縱	¯dzʊŋ
中	中	¯dzʊŋ
种	種	¯dzʊŋ
众	眾	¯dzʊŋ
粽	粽	¯dzʊŋ/´dzʊŋ
斫	斲	¯dœk
琢	琢	¯dœk
啄	啄	¯dœk
涿	涿	¯dœk
对	對	¯dœy
碲	碲	¯dɐi
帝	帝	¯dɐi
谛	諦	¯dɐi
缔	締	¯dɐi
蒂	蒂	¯dɐi
斗	鬥	¯dɐu
磴	磴	¯dɐŋ
镫	鐙	¯dɐŋ
凳	凳	¯dɐŋ
当	當	¯dɔŋ
档	檔	¯dɔŋ
碇	碇	¯dɪŋ
锭	錠	¯dɪŋ/_dɪŋ
订	訂	¯dɪŋ/_dɪŋ
冻	凍	¯dʊŋ
栋	棟	¯dʊŋ
化	化	¯fa
块	塊	¯fai
傀	傀	¯fai
筷	筷	¯fai
快	快	¯fai
哙	噲	¯fai
泛	泛	¯fan/_fan
贩	販	¯fan/´fan
法	法	¯fat
珐	琺	¯fat
发	髮	¯fat
发	發	¯fat
裤	褲	¯fu
赋	賦	¯fu
富	富	¯fu
戽	戽	¯fu
库	庫	¯fu
绔	絝	¯fu
副	副	¯fu
晦	晦	¯fui
悔	悔	¯fui
诲	誨	¯fui
阔	闊	¯fut
肺	肺	¯fɐi
沸	沸	¯fɐi
废	廢	¯fɐi
费	費	¯fɐi
狒	狒	¯fɐi
训	訓	¯fɐn
粪	糞	¯fɐn
货	貨	¯fɔ
课	課	¯fɔ
霍	霍	¯fɔk
攫	攫	¯fɔk
况	況	¯fɔŋ
放	放	¯fɔŋ
讽	諷	¯fʊŋ
稼	稼	¯ga
嫁	嫁	¯ga
价	價	¯ga
咖	咖	¯ga
假	假	¯ga
架	架	¯ga
驾	駕	¯ga
诫	誡	¯gai
疥	疥	¯gai
芥	芥	¯gai
戒	戒	¯gai
界	界	¯gai
尬	尬	¯gai
届	屆	¯gai
介	介	¯gai
解	解	¯gai
嗝	嗝	¯gak
骼	骼	¯gak
膈	膈	¯gak
镉	鎘	¯gak
隔	隔	¯gak
革	革	¯gak
格	格	¯gak
胳	胳	¯gak
监	監	¯gam
鉴	鑑	¯gam
谏	諫	¯gan
涧	澗	¯gan
间	間	¯gan
胛	胛	¯gap
蛱	蛺	¯gap
钾	鉀	¯gap
颊	頰	¯gap
甲	甲	¯gap
饸	餄	¯gap
荚	莢	¯gap
夹	夾	¯gap
郏	郟	¯gap
岬	岬	¯gap
袷	袷	¯gap
轧	軋	¯gat
窖	窖	¯gau
较	較	¯gau
铰	鉸	¯gau
觉	覺	¯gau
教	教	¯gau
校	校	¯gau
酵	酵	¯gau/'hau
纪	紀	¯gei
觊	覬	¯gei
记	記	¯gei
寄	寄	¯gei
既	既	¯gei
剑	劍	¯gim
腱	腱	¯gin
见	見	¯gin
建	建	¯gin
劫	劫	¯gip
拮	拮	¯git
洁	潔	¯git
结	結	¯git
叫	叫	¯giu
郜	郜	¯gou
告	告	¯gou
锆	鋯	¯gou
故	故	¯gu
锢	錮	¯gu
顾	顧	¯gu
雇	僱	¯gu
固	固	¯gu
罐	罐	¯gun
盥	盥	¯gun
鹳	鸛	¯gun
贯	貫	¯gun
冠	冠	¯gun
灌	灌	¯gun
褂	褂	¯gwa
挂	掛	¯gwa
卦	卦	¯gwa
怪	怪	¯gwai
掴	摑	¯gwak
惯	慣	¯gwan
掼	摜	¯gwan
刮	颳	¯gwat
刮	刮	¯gwat
季	季	¯gwɐi
瑰	瑰	¯gwɐi
癸	癸	¯gwɐi
悸	悸	¯gwɐi
桂	桂	¯gwɐi
贵	貴	¯gwɐi
棍	棍	¯gwɐn
过	過	¯gwɔ
帼	幗	¯gwɔk
郭	郭	¯gwɔk
腘	膕	¯gwɔk
国	國	¯gwɔk
廓	廓	¯gwɔk/¯kwɔk
桄	桄	¯gwɔŋ
绢	絹	¯gyn
券	券	¯gyn
眷	眷	¯gyn
鄄	鄄	¯gyn
脚	腳	¯gœk
句	句	¯gœy
据	據	¯gœy
踞	踞	¯gœy
锯	鋸	¯gœy/¯gɛu
计	計	¯gɐi
髻	髻	¯gɐi
继	繼	¯gɐi
蓟	薊	¯gɐi
淦	淦	¯gɐm
赣	贛	¯gɐm
禁	禁	¯gɐm
噤	噤	¯gɐm
靳	靳	¯gɐn
艮	艮	¯gɐn
觐	覲	¯gɐn/´gɐn
鸽	鴿	¯gɐp
蛤	蛤	¯gɐp
嘎	嘎	¯gɐt
灸	灸	¯gɐu
垢	垢	¯gɐu
够	夠	¯gɐu
诟	詬	¯gɐu
救	救	¯gɐu
疚	疚	¯gɐu
究	究	¯gɐu
柩	柩	¯gɐu
厩	廄	¯gɐu
咎	咎	¯gɐu
更	更	¯gɐŋ
个	個	¯gɔ
盖	蓋	¯gɔi
各	各	¯gɔk
觉	覺	¯gɔk
搁	擱	¯gɔk
阁	閣	¯gɔk
角	角	¯gɔk
干	幹	¯gɔn
葛	葛	¯gɔt
割	割	¯gɔt
绛	絳	¯gɔŋ
钢	鋼	¯gɔŋ
杠	槓	¯gɔŋ
降	降	¯gɔŋ
镜	鏡	¯gɛŋ
径	徑	¯gɪŋ
径	逕	¯gɪŋ
敬	敬	¯gɪŋ
劲	勁	¯gɪŋ
供	供	¯gʊŋ
贡	貢	¯gʊŋ
吓	嚇	¯hak
客	客	¯hak
喊	喊	¯ham
嗑	嗑	¯hap
掐	掐	¯hap
呷	呷	¯hap
孝	孝	¯hau
器	器	¯hei
汽	汽	¯hei
戏	戲	¯hei
气	氣	¯hei
弃	棄	¯hei
憩	憩	¯hei
欠	欠	¯him
芡	芡	¯him
宪	憲	¯hin
献	獻	¯hin
歉	歉	¯hip
协	協	¯hip
怯	怯	¯hip
胁	脅	¯hip
挟	挾	¯hip/_hap
蝎	蠍	¯hit
歇	歇	¯hit
窍	竅	¯hiu/¯kiu
犒	犒	¯hou
耗	耗	¯hou
好	好	¯hou
劝	勸	¯hyn
券	券	¯hyn
绻	綣	¯hyn
绚	絢	¯hyn
血	血	¯hyt
去	去	¯hœy
向	嚮	¯hœŋ
向	向	¯hœŋ
磡	磡	¯hɐm
瞰	瞰	¯hɐm
崁	崁	¯hɐm
勘	勘	¯hɐm
嵌	嵌	¯hɐm/_hɐm
吼	吼	¯hɐu
壳	殼	¯hɔk
汉	漢	¯hɔn
看	看	¯hɔn
喝	喝	¯hɔt
褐	褐	¯hɔt
渴	渴	¯hɔt
鞨	鞨	¯hɔt
吃	吃	¯hɛk
磬	磬	¯hɪŋ
庆	慶	¯hɪŋ
罄	罄	¯hɪŋ
兴	興	¯hɪŋ
控	控	¯hʊŋ
汞	汞	¯hʊŋ
哄	哄	¯hʊŋ
烘	烘	¯hʊŋ/'hʊŋ
哄	鬨	¯hʊŋ/_hʊŋ
镱	鐿	¯ji
意	意	¯ji
懿	懿	¯ji
薏	薏	¯ji
癔	癔	¯ji
厌	厭	¯jim
餍	饜	¯jim
燕	燕	¯jin
咽	嚥	¯jin
宴	宴	¯jin
靥	靨	¯jip
咽	咽	¯jit
噎	噎	¯jit
谒	謁	¯jit
要	要	¯jiu
酗	酗	¯jy/´hœy/¯hœy
怨	怨	¯jyn
约	約	¯jœk
荫	蔭	¯jɐm
窨	窨	¯jɐm
印	印	¯jɐn
幼	幼	¯jɐu
应	應	¯jɪŋ
髂	髂	¯ka
揢	揢	¯kak
咯	咯	¯kak
靠	靠	¯kau
铐	銬	¯kau
冀	冀	¯kei
暨	暨	¯kei
骥	驥	¯kei
孑	孑	¯kit
颉	頡	¯kit
黠	黠	¯kit
揭	揭	¯kit
锲	鍥	¯kit
竭	竭	¯kit
羯	羯	¯kit
诘	詰	¯kit
撷	擷	¯kit/¯git
翘	翹	¯kiu/¯hiu
聒	聒	¯kut
蛞	蛞	¯kut
豁	豁	¯kut
括	括	¯kut
挎	挎	¯kwa
跨	跨	¯kwa
胯	胯	¯kwa
逛	逛	¯kwaŋ
困	困	¯kwɐn
困	睏	¯kwɐn
窘	窘	¯kwɐn
扩	擴	¯kwɔk
旷	曠	¯kwɔŋ
邝	鄺	¯kwɔŋ/¯kɔŋ
矿	礦	¯kwɔŋ/¯kɔŋ
撅	撅	¯kyt
厥	厥	¯kyt
蕨	蕨	¯kyt
阙	闕	¯kyt
缺	缺	¯kyt
决	決	¯kyt
蹶	蹶	¯kyt
孓	孓	¯kyt
抉	抉	¯kyt
诀	訣	¯kyt
獗	獗	¯kyt
橛	橛	¯kyt/_gyt
却	卻	¯kœk
契	契	¯kɐi
叩	叩	¯kɐu
寇	寇	¯kɐu
蔻	蔻	¯kɐu
扣	釦	¯kɐu
扣	扣	¯kɐu
购	購	¯kɐu/¯gɐu
构	構	¯kɐu/¯gɐu
媾	媾	¯kɐu/¯gɐu
欬	欬	¯kɔi
忾	愾	¯kɔi
丐	丐	¯kɔi
概	概	¯kɔi
盖	蓋	¯kɔi
溉	溉	¯kɔi
慨	慨	¯kɔi
钙	鈣	¯kɔi
恪	恪	¯kɔk
郝	郝	¯kɔk
悫	慤	¯kɔk
壑	壑	¯kɔk
涸	涸	¯kɔk
确	確	¯kɔk
榷	榷	¯kɔk
闶	閌	¯kɔŋ
炕	炕	¯kɔŋ
扩	擴	¯kɔŋ
伉	伉	¯kɔŋ
抗	抗	¯kɔŋ
亢	亢	¯kɔŋ
喇	喇	¯la
癞	癩	¯lai
捋	捋	¯lyt
劣	劣	¯lyt/_lyt
珞	珞	¯lɔk
酪	酪	¯lɔk
饹	餎	¯lɔk
铬	鉻	¯lɔk
络	絡	¯lɔk
烙	烙	¯lɔk
洛	洛	¯lɔk/_lɔk
骆	駱	¯lɔk/_lɔk
靓	靚	¯lɛŋ
嘛	嘛	¯ma
擘	擘	¯mak
沫	沫	¯mut
抹	抹	¯mut/¯mat
怕	怕	¯pa
派	派	¯pai
哌	哌	¯pai
湃	湃	¯pai/¯bai
魄	魄	¯pak
帕	帕	¯pak
柏	柏	¯pak
拍	拍	¯pak
珀	珀	¯pak
袢	袢	¯pan
盼	盼	¯pan
泡	泡	¯pau
疱	疱	¯pau
豹	豹	¯pau
炮	炮	¯pau
譬	譬	¯pei
濞	濞	¯pei
屁	屁	¯pei
媲	媲	¯pei/´bei
片	片	¯pin
遍	遍	¯pin
骗	騙	¯pin
瞥	瞥	¯pit
撇	撇	¯pit
漂	漂	¯piu
票	票	¯piu
剽	剽	¯piu/ˏpiu
铺	舖	¯pou
沛	沛	¯pui
佩	佩	¯pui
霈	霈	¯pui
配	配	¯pui
珮	珮	¯pui
判	判	¯pun
拚	拚	¯pun
泼	潑	¯put
喷	噴	¯pɐn
破	破	¯pɔ
璞	璞	¯pɔk
噗	噗	¯pɔk
扑	撲	¯pɔk
朴	樸	¯pɔk
钋	釙	¯pɔk
粕	粕	¯pɔk/¯pak
谤	謗	¯pɔŋ
劈	劈	¯pɛk
聘	聘	¯pɪŋ
碰	碰	¯pʊŋ
晒	曬	¯sai
索	索	¯sak/¯sɔk
三	三	¯sam
讪	訕	¯san
篡	篡	¯san
散	散	¯san
伞	傘	¯san
涮	涮	¯san
疝	疝	¯san
汕	汕	¯san
飒	颯	¯sap
圾	圾	¯sap
铩	鎩	¯sat
萨	薩	¯sat
撒	撒	¯sat
刹	剎	¯sat
杀	殺	¯sat
煞	煞	¯sat
哨	哨	¯sau
四	四	¯sei
使	使	¯si
泗	泗	¯si
弑	弒	¯si
试	試	¯si
嗜	嗜	¯si
谥	諡	¯si
驷	駟	¯si
肆	肆	¯si
腺	腺	¯sin
扇	扇	¯sin
煽	煽	¯sin
霰	霰	¯sin
线	線	¯sin
骟	騸	¯sin
摄	攝	¯sip
涉	涉	¯sip
歙	歙	¯sip
慑	懾	¯sip/¯dzip
屑	屑	¯sit
窃	竊	¯sit
绁	絏	¯sit
亵	褻	¯sit
舌	舌	¯sit
泄	洩	¯sit
楔	楔	¯sit
薛	薛	¯sit
揳	揳	¯sit/¯sip
啸	嘯	¯siu
笑	笑	¯siu
少	少	¯siu
数	數	¯sou
溯	溯	¯sou
素	素	¯sou
扫	掃	¯sou
臊	臊	¯sou
塑	塑	¯sou
诉	訴	¯sou
愫	愫	¯sou
庶	庶	¯sy
恕	恕	¯sy
戍	戍	¯sy
蒜	蒜	¯syn
算	算	¯syn
渲	渲	¯syn/'hyn
雪	雪	¯syt
鳕	鱈	¯syt
说	說	¯syt
烁	爍	¯sœk
铄	鑠	¯sœk
削	削	¯sœk
舜	舜	¯sœn
瞬	瞬	¯sœn
逊	遜	¯sœn
汛	汛	¯sœn
信	信	¯sœn
浚	浚	¯sœn
巽	巽	¯sœn
讯	訊	¯sœn
迅	迅	¯sœn
囟	囟	¯sœn/´sœn
税	稅	¯sœy
说	說	¯sœy
碎	碎	¯sœy
帅	帥	¯sœy
岁	歲	¯sœy
相	相	¯sœŋ
世	世	¯sɐi
势	勢	¯sɐi
细	細	¯sɐi
婿	婿	¯sɐi
沁	沁	¯sɐm
渗	滲	¯sɐm
霎	霎	¯sɐp
秀	秀	¯sɐu
嗽	嗽	¯sɐu
锈	鏽	¯sɐu
兽	獸	¯sɐu
瘦	瘦	¯sɐu
狩	狩	¯sɐu
琇	琇	¯sɐu
绣	繡	¯sɐu
宿	宿	¯sɐu
漱	漱	¯sɐu
蹭	蹭	¯sɐŋ
擤	擤	¯sɐŋ
朔	朔	¯sɔk
说	說	¯sɔk
索	索	¯sɔk
丧	喪	¯sɔŋ
猞	猞	¯sɛ
卸	卸	¯sɛ
赦	赦	¯sɛ
泻	瀉	¯sɛ
舍	舍	¯sɛ
锡	錫	¯sɛk
圣	聖	¯sɪŋ
性	性	¯sɪŋ
姓	姓	¯sɪŋ
胜	勝	¯sɪŋ
宋	宋	¯sʊŋ
送	送	¯sʊŋ
态	態	¯tai
肽	肽	¯tai
泰	泰	¯tai
太	太	¯tai
贷	貸	¯tai
汰	汰	¯tai
钛	鈦	¯tai
傣	傣	¯tai
探	探	¯tam
坛	罈	¯tam
碳	碳	¯tan
叹	歎	¯tan
炭	炭	¯tan
塔	塔	¯tap
榻	榻	¯tap
塌	塌	¯tap
漯	漯	¯tap
遢	遢	¯tap/¯tat
鞑	韃	¯tat
趿	趿	¯tat
挞	撻	¯tat
跶	躂	¯tat
闼	闥	¯tat
帖	帖	¯tip
贴	貼	¯tip
萜	萜	¯tip
铁	鐵	¯tit
餮	餮	¯tit
眺	眺	¯tiu
跳	跳	¯tiu
兔	兔	¯tou
套	套	¯tou
吐	吐	¯tou
姹	姹	¯tsa
衩	衩	¯tsa
诧	詫	¯tsa
杈	杈	¯tsa
岔	岔	¯tsa
虿	蠆	¯tsai
策	策	¯tsak
栅	柵	¯tsak
册	冊	¯tsak
拆	拆	¯tsak
忏	懺	¯tsam
杉	杉	¯tsam/'sam
灿	燦	¯tsan
璨	璨	¯tsan
插	插	¯tsap
锸	鍤	¯tsap
察	察	¯tsat
刷	刷	¯tsat
獭	獺	¯tsat
擦	擦	¯tsat
刹	剎	¯tsat/¯sat
肏	肏	¯tsau
次	次	¯tsi
帜	幟	¯tsi
刺	刺	¯tsi
翅	翅	¯tsi
厕	廁	¯tsi
赐	賜	¯tsi
炽	熾	¯tsi
堑	塹	¯tsim
僭	僭	¯tsim
暹	暹	¯tsim/'tsim
妾	妾	¯tsip
澈	澈	¯tsit
辙	轍	¯tsit
设	設	¯tsit
切	切	¯tsit
撤	撤	¯tsit
掣	掣	¯tsit
彻	徹	¯tsit
俏	俏	¯tsiu
肖	肖	¯tsiu
鞘	鞘	¯tsiu
峭	峭	¯tsiu
醋	醋	¯tsou
措	措	¯tsou
糙	糙	¯tsou
燥	燥	¯tsou
噪	噪	¯tsou
躁	躁	¯tsou
操	操	¯tsou/'tsou
处	處	¯tsy
串	串	¯tsyn
寸	寸	¯tsyn
爨	爨	¯tsyn
窜	竄	¯tsyn
吋	吋	¯tsyn
撮	撮	¯tsyt
猝	猝	¯tsyt
踅	踅	¯tsyt
绰	綽	¯tsœk
卓	卓	¯tsœk
戳	戳	¯tsœk
脆	脆	¯tsœy
趣	趣	¯tsœy
翠	翠	¯tsœy
啐	啐	¯tsœy
觑	覷	¯tsœy
淬	淬	¯tsœy/_sœy
焠	焠	¯tsœy/_sœy
呛	嗆	¯tsœŋ
戗	戧	¯tsœŋ
唱	唱	¯tsœŋ
怅	悵	¯tsœŋ
跄	蹌	¯tsœŋ
炝	熗	¯tsœŋ
畅	暢	¯tsœŋ
倡	倡	¯tsœŋ
切	切	¯tsɐi
砌	砌	¯tsɐi
沏	沏	¯tsɐi
谶	讖	¯tsɐm/¯tsam
龀	齔	¯tsɐn
趁	趁	¯tsɐn
衬	襯	¯tsɐn
嗅	嗅	¯tsɐu
臭	臭	¯tsɐu
糗	糗	¯tsɐu
溴	溴	¯tsɐu
凑	湊	¯tsɐu
挫	挫	¯tsɔ
锉	銼	¯tsɔ
错	錯	¯tsɔ
菜	菜	¯tsɔi
蔡	蔡	¯tsɔi
塞	塞	¯tsɔi
赛	賽	¯tsɔi
错	錯	¯tsɔk
创	創	¯tsɔŋ
尺	尺	¯tsɛk
呎	呎	¯tsɛk
赤	赤	¯tsɛk
秤	秤	¯tsɪŋ
称	稱	¯tsɪŋ
称	稱	¯tsɪŋ/¯tsɐŋ
脱	脫	¯tyt
彖	彖	¯tœn
退	退	¯tœy
蜕	蛻	¯tœy
屉	屜	¯tɐi
剃	剃	¯tɐi
替	替	¯tɐi
涕	涕	¯tɐi
嚏	嚏	¯tɐi
褪	褪	¯tɐn
透	透	¯tɐu
唾	唾	¯tɔ/¯tɛu
庹	庹	¯tɔk
托	託	¯tɔk
橐	橐	¯tɔk
托	托	¯tɔk
拓	拓	¯tɔk
趟	趟	¯tɔŋ
蹚	蹚	¯tɔŋ
熨	熨	¯tɔŋ
烫	燙	¯tɔŋ
踢	踢	¯tɛk
听	聽	¯tɪŋ
痛	痛	¯tʊŋ
斡	斡	¯wat
挖	挖	¯wat
恶	惡	¯wu
慰	慰	¯wɐi
尉	尉	¯wɐi
蔚	蔚	¯wɐi
秽	穢	¯wɐi
畏	畏	¯wɐi
喂	餵	¯wɐi
喂	喂	¯wɐi
荟	薈	¯wɐi/_wui
蕴	蘊	¯wɐn
愠	慍	¯wɐn
酝	醞	¯wɐn
揾	搵	¯wɐn
懊	懊	¯ŋou
澳	澳	¯ŋou
奥	奧	¯ŋou
袄	襖	¯ŋou/´ŋou
盎	盎	¯ŋɔŋ/´ŋɔŋ
屃	屭	¯ɐi
缢	縊	¯ɐi
唉	唉	¯ɐi
暗	暗	¯ɐm
怄	慪	¯ɐu
凹	凹	¯ɐu/'nɐp
爱	愛	¯ɔi
瑷	璦	¯ɔi
垩	堊	¯ɔk
恶	惡	¯ɔk
恶	噁	¯ɔk
按	按	¯ɔn
摁	摁	¯ɔn
案	案	¯ɔn
瓮	甕	¯ʊŋ
齆	齆	¯ʊŋ
啊	啊	´a
哑	啞	´a
俺	俺	´an
把	把	´ba
钯	鈀	´ba
靶	靶	´ba
捭	捭	´bai
摆	襬	´bai
摆	擺	´bai
舨	舨	´ban
板	板	´ban
坂	坂	´ban
版	版	´ban
板	闆	´ban
饱	飽	´bau
彼	彼	´bei
比	比	´bei
妣	妣	´bei
匕	匕	´bei/¯bei
贬	貶	´bin
匾	匾	´bin
扁	扁	´bin
表	表	´biu
婊	婊	´biu
圃	圃	´bou
保	保	´bou
鸨	鴇	´bou
宝	寶	´bou
堡	堡	´bou
补	補	´bou
葆	葆	´bou
畚	畚	´bun
本	本	´bun
苯	苯	´bun
禀	稟	´bɐn
品	品	´bɐn
绑	綁	´bɔŋ
榜	榜	´bɔŋ
蒡	蒡	´bɔŋ
膀	膀	´bɔŋ
饼	餅	´bɛŋ
炳	炳	´bɪŋ
饼	餅	´bɪŋ
屏	屏	´bɪŋ
秉	秉	´bɪŋ
丙	丙	´bɪŋ
打	打	´da
歹	歹	´dai
胆	膽	´dam
弹	彈	´dan
点	點	´dim
碘	碘	´din
垫	墊	´din
典	典	´din
屌	屌	´diu
赌	賭	´dou
堵	堵	´dou
岛	島	´dou
睹	睹	´dou
捣	搗	´dou
倒	倒	´dou
短	短	´dyn
崭	嶄	´dzam
斩	斬	´dzam
攒	攢	´dzan
趱	趲	´dzan
盏	盞	´dzan
爪	爪	´dzau
找	找	´dzau
滓	滓	´dzi
芷	芷	´dzi
趾	趾	´dzi
子	子	´dzi
止	止	´dzi
酯	酯	´dzi
祉	祉	´dzi
籽	籽	´dzi
秭	秭	´dzi
梓	梓	´dzi
咫	咫	´dzi
仔	仔	´dzi
只	只	´dzi
指	指	´dzi
纸	紙	´dzi
旨	旨	´dzi
紫	紫	´dzi
姊	姊	´dzi
址	址	´dzi
碾	碾	´dzin
辗	輾	´dzin
展	展	´dzin
剪	剪	´dzin
翦	翦	´dzin
阐	闡	´dzin/´tsin
沼	沼	´dziu
剿	剿	´dziu
组	組	´dzou
枣	棗	´dzou
澡	澡	´dzou
驵	駔	´dzou
藻	藻	´dzou
祖	祖	´dzou
蚤	蚤	´dzou
早	早	´dzou
煮	煮	´dzy
主	主	´dzy
转	轉	´dzyn
传	傳	´dzyn
纂	纂	´dzyn
准	准	´dzœn
隼	隼	´dzœn
尽	儘	´dzœn
准	準	´dzœn
沮	沮	´dzœy
咀	咀	´dzœy
龃	齟	´dzœy
嘴	嘴	´dzœy
掌	掌	´dzœŋ
桨	槳	´dzœŋ
奖	獎	´dzœŋ
蒋	蔣	´dzœŋ
长	長	´dzœŋ
涨	漲	´dzœŋ/¯dzœŋ
济	濟	´dzɐi
仔	仔	´dzɐi
枕	枕	´dzɐm
怎	怎	´dzɐm
疹	疹	´dzɐn
轸	軫	´dzɐn/´tsɐn
帚	帚	´dzɐu
走	走	´dzɐu
酒	酒	´dzɐu
肘	肘	´dzɐu
阻	阻	´dzɔ
左	左	´dzɔ
俎	俎	´dzɔ
崽	崽	´dzɔi
宰	宰	´dzɔi
载	載	´dzɔi
驵	駔	´dzɔŋ
姐	姐	´dzɛ
者	者	´dzɛ
整	整	´dzɪŋ
井	井	´dzɪŋ/´dzɛŋ
种	種	´dzʊŋ
肿	腫	´dzʊŋ
总	總	´dzʊŋ
邸	邸	´dɐi
诋	詆	´dɐi
柢	柢	´dɐi
底	底	´dɐi
骶	骶	´dɐi
抵	抵	´dɐi
墩	墩	´dɐn
斗	斗	´dɐu
蚪	蚪	´dɐu
陡	陡	´dɐu
抖	抖	´dɐu
等	等	´dɐŋ
跺	跺	´dɔ
躲	躲	´dɔ
剁	剁	´dɔ/¯dœk
朵	朵	´dɔ/´dɛu
挡	擋	´dɔŋ
党	黨	´dɔŋ
嗲	嗲	´dɛ
顶	頂	´dɪŋ
鼎	鼎	´dɪŋ
酊	酊	´dɪŋ
董	董	´dʊŋ
懂	懂	´dʊŋ
踵	踵	´dʊŋ
欸	欸	´ei
犯	犯	´fan
反	反	´fan
返	返	´fan
悱	悱	´fei
诽	誹	´fei
斐	斐	´fei
翡	翡	´fei
榧	榧	´fei
匪	匪	´fei
府	府	´fu
抚	撫	´fu
腑	腑	´fu
唬	唬	´fu
拊	拊	´fu
虎	虎	´fu
釜	釜	´fu
斧	斧	´fu
俯	俯	´fu
苦	苦	´fu
琥	琥	´fu
甫	甫	´fu
鲔	鮪	´fui
款	款	´fun
粉	粉	´fɐn
否	否	´fɐu
伙	伙	´fɔ
火	火	´fɔ
伙	夥	´fɔ
颗	顆	´fɔ
晃	晃	´fɔŋ
访	訪	´fɔŋ
幌	幌	´fɔŋ
纺	紡	´fɔŋ
仿	彷	´fɔŋ
恍	恍	´fɔŋ
仿	仿	´fɔŋ
槚	檟	´ga
假	假	´ga
贾	賈	´ga
架	架	´ga
斝	斝	´ga
尕	尕	´ga
解	解	´gai
蚧	蚧	´gai/´gwai
减	減	´gam
柬	柬	´gan
拣	揀	´gan
简	簡	´gan
茧	繭	´gan
锏	鐧	´gan
碱	鹼	´gan
饺	餃	´gau
姣	姣	´gau
狡	狡	´gau
皎	皎	´gau
佼	佼	´gau
铰	鉸	´gau
绞	絞	´gau
搅	攪	´gau
搞	搞	´gau
己	己	´gei
杞	杞	´gei
纪	紀	´gei
几	幾	´gei
检	檢	´gim
睑	瞼	´gim
捡	撿	´gim
矫	矯	´giu
缴	繳	´giu
稿	稿	´gou
槁	槁	´gou
镐	鎬	´gou
缟	縞	´gou
杲	杲	´gou
藁	藁	´gou
估	估	´gu
古	古	´gu
鼓	鼓	´gu
股	股	´gu
贾	賈	´gu
蛊	蠱	´gu
钴	鈷	´gu
牯	牯	´gu
莞	莞	´gun
馆	館	´gun
管	管	´gun
脘	脘	´gun
寡	寡	´gwa
柺	柺	´gwai
拐	拐	´gwai
蒯	蒯	´gwai
轨	軌	´gwɐi
鬼	鬼	´gwɐi
诡	詭	´gwɐi
晷	晷	´gwɐi
滚	滾	´gwɐn
裹	裹	´gwɔ
果	果	´gwɔ
广	廣	´gwɔŋ
犷	獷	´gwɔŋ
诳	誑	´gwɔŋ
炯	炯	´gwɪŋ
迥	迥	´gwɪŋ
卷	卷	´gyn
卷	捲	´gyn
矩	矩	´gœy
榉	櫸	´gœy
蒟	蒟	´gœy
龋	齲	´gœy
莒	莒	´gœy
举	舉	´gœy
感	感	´gɐm
敢	敢	´gɐm
橄	橄	´gɐm
锦	錦	´gɐm
紧	緊	´gɐn
馑	饉	´gɐn
堇	堇	´gɐn
谨	謹	´gɐn
仅	僅	´gɐn
瑾	瑾	´gɐn
韭	韭	´gɐu
九	九	´gɐu
久	久	´gɐu
狗	狗	´gɐu
苟	苟	´gɐu
玖	玖	´gɐu
枸	枸	´gɐu
纠	糾	´gɐu/´dɐu
耿	耿	´gɐŋ
埂	埂	´gɐŋ
梗	梗	´gɐŋ
亘	亙	´gɐŋ
哽	哽	´gɐŋ
鲠	鯁	´gɐŋ/´kɐŋ
改	改	´gɔi
赶	趕	´gɔn
擀	擀	´gɔn
杆	桿	´gɔn
港	港	´gɔŋ
讲	講	´gɔŋ
颈	頸	´gɛŋ
警	警	´gɪŋ
璟	璟	´gɪŋ
竟	竟	´gɪŋ
景	景	´gɪŋ
境	境	´gɪŋ
憬	憬	´gɪŋ
儆	儆	´gɪŋ
珙	珙	´gʊŋ
拱	拱	´gʊŋ
巩	鞏	´gʊŋ
考	考	´hau
拷	拷	´hau
巧	巧	´hau
囍	囍	´hei
喜	喜	´hei
岂	豈	´hei
起	起	´hei
险	險	´him
缱	繾	´hin
遣	遣	´hin
显	顯	´hin
谴	譴	´hin
蚬	蜆	´hin
晓	曉	´hiu
好	好	´hou
犬	犬	´hyn
畎	畎	´hyn
栩	栩	´hœy
诩	詡	´hœy
许	許	´hœy
煦	煦	´hœy/¯hœy
飨	饗	´hœŋ
饷	餉	´hœŋ
晌	晌	´hœŋ
响	響	´hœŋ
享	享	´hœŋ
砍	砍	´hɐm
坎	坎	´hɐm
恳	懇	´hɐn
狠	狠	´hɐn
垦	墾	´hɐn
很	很	´hɐn
口	口	´hɐu
肯	肯	´hɐŋ
啃	啃	´hɐŋ
可	可	´hɔ
嗬	嗬	´hɔ
坷	坷	´hɔ
岢	岢	´hɔ
垲	塏	´hɔi
铠	鎧	´hɔi
海	海	´hɔi
剀	剴	´hɔi
闿	闓	´hɔi
凯	凱	´hɔi
恺	愷	´hɔi
罕	罕	´hɔn
侃	侃	´hɔn
刊	刊	´hɔn/'hɔn
慷	慷	´hɔŋ/´kɔŋ
孔	孔	´hʊŋ
恐	恐	´hʊŋ
绮	綺	´ji
齮	齮	´ji
旖	旖	´ji
倚	倚	´ji
椅	椅	´ji
掩	掩	´jim
魇	魘	´jim
演	演	´jin
兖	兗	´jin
堰	堰	´jin
鼹	鼴	´jin
偃	偃	´jin
衍	衍	´jin/´hin
窈	窈	´jiu
扰	擾	´jiu
夭	夭	´jiu
绕	繞	´jiu/ˏjiu
瘀	瘀	´jy
妪	嫗	´jy
伛	傴	´jy
菀	菀	´jyn
宛	宛	´jyn
苑	苑	´jyn
婉	婉	´jyn
琬	琬	´jyn
鞅	鞅	´jœŋ
饮	飲	´jɐm
瘾	癮	´jɐn
隐	隱	´jɐn
忍	忍	´jɐn
柚	柚	´jɐu
黝	黝	´jɐu
影	影	´jɪŋ
映	映	´jɪŋ
恿	慂	´jʊŋ
冗	冗	´jʊŋ
臃	臃	´jʊŋ
蛹	蛹	´jʊŋ
佣	佣	´jʊŋ
涌	湧	´jʊŋ
俑	俑	´jʊŋ
踊	踴	´jʊŋ
拥	擁	´jʊŋ
卡	卡	´ka
蒈	蒈	´kai
楷	楷	´kai
锴	鍇	´kai/'gai
侩	儈	´kui
桧	檜	´kui
脍	膾	´kui
浍	澮	´kui
郐	鄶	´kui
鲙	鱠	´kui
绘	繪	´kui
聩	聵	´kui
狯	獪	´kui
刽	劊	´kui
贿	賄	´kui
溃	潰	´kui
会	會	´kui/_wui
侉	侉	´kwa
菌	菌	´kwɐn
捆	捆	´kwɐn
启	啟	´kɐi
茄	茄	´kɛ
顷	頃	´kɪŋ
佬	佬	´lou
恋	戀	´lyn
脔	臠	´lyn/ˌlyn
卵	卵	´lœn
两	兩	´lœŋ
搂	摟	´lɐu
裸	裸	´lɔ
郎	郎	´lɔŋ
咧	咧	´lɛ
摸	摸	´mɔ
捻	捻	´nim
朽	朽	´nɐu
钮	鈕	´nɐu
纽	紐	´nɐu
扭	扭	´nɐu
狃	狃	´nɐu
妞	妞	´nɐu
媪	媼	´ou
跑	跑	´pau
否	否	´pei
鄙	鄙	´pei
痞	痞	´pei
仳	仳	´pei
圮	圮	´pei
吡	吡	´pei
片	片	´pin
片	片	´pin
溥	溥	´pou
浦	浦	´pou
普	普	´pou
谱	譜	´pou
脯	脯	´pou/´fu
剖	剖	´pɐu
笸	笸	´pɔ
叵	叵	´pɔ
颇	頗	´pɔ
捧	捧	´pʊŋ/´bʊŋ
洒	灑	´sa
耍	耍	´sa
玺	璽	´sai
徙	徙	´sai
散	散	´san
稍	稍	´sau
省	省	´saŋ
死	死	´sei
屎	屎	´si
史	史	´si
使	使	´si
闪	閃	´sim
陕	陝	´sim
鲜	鮮	´sin
跣	跣	´sin
冼	冼	´sin
癣	癬	´sin
少	少	´siu
小	小	´siu
筱	筱	´siu
嫂	嫂	´sou
数	數	´sou
暑	暑	´sy
黍	黍	´sy
鼠	鼠	´sy
损	損	´syn
选	選	´syn
榫	榫	´sœn
笋	筍	´sœn
水	水	´sœy
鲞	鯗	´sœŋ
赏	賞	´sœŋ
想	想	´sœŋ
使	使	´sɐi
洗	洗	´sɐi
驶	駛	´sɐi
沈	瀋	´sɐm
沈	沈	´sɐm
婶	嬸	´sɐm
审	審	´sɐm
守	守	´sɐu
首	首	´sɐu
搜	搜	´sɐu
手	手	´sɐu
嗾	嗾	´sɐu
擞	擻	´sɐu
艘	艘	´sɐu/'sɐu
所	所	´sɔ
锁	鎖	´sɔ
唢	嗩	´sɔ
琐	瑣	´sɔ
搡	搡	´sɔŋ
爽	爽	´sɔŋ
嗓	嗓	´sɔŋ
写	寫	´sɛ
舍	捨	´sɛ
省	省	´sɪŋ
醒	醒	´sɪŋ/´sɛŋ
耸	聳	´sʊŋ
怂	慫	´sʊŋ
竦	竦	´sʊŋ
悚	悚	´sʊŋ
毯	毯	´tam
忐	忐	´tan
疸	疸	´tan
袒	袒	´tan
钽	鉭	´tan
坦	坦	´tan
亶	亶	´tan
舔	舔	´tim
腆	腆	´tin
讨	討	´tou
钍	釷	´tou
祷	禱	´tou
土	土	´tou
踩	踩	´tsai
踹	踹	´tsai
惨	慘	´tsam
产	產	´tsan
铲	鏟	´tsan
炒	炒	´tsau
吵	吵	´tsau
豕	豕	´tsi
矢	矢	´tsi
褫	褫	´tsi
跐	跐	´tsi
始	始	´tsi
此	此	´tsi
齿	齒	´tsi
侈	侈	´tsi
耻	恥	´tsi
谄	諂	´tsim
浅	淺	´tsin
悄	悄	´tsiu
悄	悄	´tsiu/'tsiu
草	草	´tsou
杵	杵	´tsy
贮	貯	´tsy
喘	喘	´tsyn
忖	忖	´tsyn
揣	揣	´tsyn
撺	攛	´tsyn/¯tsyn
蠢	蠢	´tsœn
揣	揣	´tsœy
娶	娶	´tsœy
取	取	´tsœy
抢	搶	´tsœŋ
寝	寢	´tsɐm
碜	磣	´tsɐm
哂	哂	´tsɐn
诊	診	´tsɐn
缜	縝	´tsɐn/´dzɐn
丑	醜	´tsɐu
丑	丑	´tsɐu
础	礎	´tsɔ
楚	楚	´tsɔ
采	采	´tsɔi
彩	綵	´tsɔi
彩	彩	´tsɔi
睬	睬	´tsɔi
采	採	´tsɔi
闯	闖	´tsɔŋ
敞	敞	´tsɔŋ
厂	廠	´tsɔŋ
氅	氅	´tsɔŋ
且	且	´tsɛ
扯	扯	´tsɛ
逞	逞	´tsɪŋ
骋	騁	´tsɪŋ
拯	拯	´tsɪŋ
请	請	´tsɪŋ/´tsɛŋ
宠	寵	´tsʊŋ
冢	冢	´tsʊŋ
腿	腿	´tœy
体	體	´tɐi
椭	橢	´tɔ
妥	妥	´tɔ
倘	倘	´tɔŋ
淌	淌	´tɔŋ
躺	躺	´tɔŋ
帑	帑	´tɔŋ
傥	儻	´tɔŋ
捅	捅	´tʊŋ
桶	桶	´tʊŋ
统	統	´tʊŋ
筒	筒	´tʊŋ/ˌtʊŋ
话	話	´wa
剐	剮	´wa
画	畫	´wa/_wa
玩	玩	´wan
绾	綰	´wan
坞	塢	´wu
浒	滸	´wu
莞	莞	´wun
腕	腕	´wun
碗	碗	´wun
豌	豌	´wun/'wun
玩	玩	´wun/_wun
惋	惋	´wun/´jyn
萎	萎	´wɐi
毁	毀	´wɐi
喟	喟	´wɐi
痿	痿	´wɐi
卉	卉	´wɐi
委	委	´wɐi
猥	猥	´wɐi
稳	穩	´wɐn
枉	枉	´wɔŋ
嗯	嗯	´ŋ̩
矮	矮	´ɐi
黯	黯	´ɐm
揞	揞	´ɐm
呕	嘔	´ɐu
殴	毆	´ɐu/'ɐu
蔼	藹	´ɔi
暧	曖	´ɔi
叆	靉	´ɔi
毐	毐	´ɔi
欸	欸	ˌei
矾	礬	ˌfan
繁	繁	ˌfan
帆	帆	ˌfan
藩	藩	ˌfan
凡	凡	ˌfan
烦	煩	ˌfan
钒	釩	ˌfan
樊	樊	ˌfan
蕃	蕃	ˌfan
梵	梵	ˌfan/_fan
肥	肥	ˌfei
腓	腓	ˌfei
乎	乎	ˌfu
芙	芙	ˌfu
符	符	ˌfu
扶	扶	ˌfu
汾	汾	ˌfɐn
坟	墳	ˌfɐn
焚	焚	ˌfɐn
浮	浮	ˌfɐu
妨	妨	ˌfɔŋ
房	房	ˌfɔŋ
防	防	ˌfɔŋ
缝	縫	ˌfʊŋ
冯	馮	ˌfʊŋ
逢	逢	ˌfʊŋ
缝	縫	ˌfʊŋ/_fʊŋ
遐	遐	ˌha
瑕	瑕	ˌha
蛤	蛤	ˌha
霞	霞	ˌha
谐	諧	ˌhai
骸	骸	ˌhai
鞋	鞋	ˌhai
孩	孩	ˌhai
涵	涵	ˌham
咸	咸	ˌham
衔	銜	ˌham
咸	鹹	ˌham
函	函	ˌham
闲	閒	ˌhan
痫	癇	ˌhan
娴	嫺	ˌhan
行	行	ˌhaŋ
嚎	嚎	ˌhou
嗥	嗥	ˌhou
壕	壕	ˌhou
豪	豪	ˌhou
蠔	蠔	ˌhou
毫	毫	ˌhou
号	號	ˌhou
奚	奚	ˌhɐi
鼷	鼷	ˌhɐi
兮	兮	ˌhɐi
酣	酣	ˌhɐm
晗	晗	ˌhɐm
含	含	ˌhɐm
痕	痕	ˌhɐn
瘊	瘊	ˌhɐu
喉	喉	ˌhɐu
侯	侯	ˌhɐu
猴	猴	ˌhɐu
篌	篌	ˌhɐu
桁	桁	ˌhɐŋ
行	行	ˌhɐŋ
恒	恆	ˌhɐŋ
衡	衡	ˌhɐŋ
荷	荷	ˌhɔ
河	河	ˌhɔ
何	何	ˌhɔ
寒	寒	ˌhɔn
鼾	鼾	ˌhɔn
韩	韓	ˌhɔn
汗	汗	ˌhɔn
邯	邯	ˌhɔn
航	航	ˌhɔŋ
降	降	ˌhɔŋ
行	行	ˌhɔŋ
吭	吭	ˌhɔŋ
杭	杭	ˌhɔŋ
鸿	鴻	ˌhʊŋ
虹	虹	ˌhʊŋ
熊	熊	ˌhʊŋ
洪	洪	ˌhʊŋ
雄	雄	ˌhʊŋ
红	紅	ˌhʊŋ
讧	訌	ˌhʊŋ/¯hʊŋ
谊	誼	ˌji
胰	胰	ˌji
颐	頤	ˌji
迤	迤	ˌji
仪	儀	ˌji
痍	痍	ˌji
宜	宜	ˌji
诒	詒	ˌji
姨	姨	ˌji
移	移	ˌji
怡	怡	ˌji
饴	飴	ˌji
儿	兒	ˌji
贻	貽	ˌji
咦	咦	ˌji
彝	彞	ˌji
而	而	ˌji
蛇	蛇	ˌji
眙	眙	ˌji
沂	沂	ˌji
夷	夷	ˌji
疑	疑	ˌji
炎	炎	ˌjim
盐	鹽	ˌjim
蚺	蚺	ˌjim
阎	閻	ˌjim
髯	髯	ˌjim
嫌	嫌	ˌjim
严	嚴	ˌjim
闫	閆	ˌjim
檐	簷	ˌjim/ˌsim
延	延	ˌjin
筵	筵	ˌjin
妍	妍	ˌjin
燃	燃	ˌjin
舷	舷	ˌjin
然	然	ˌjin
涎	涎	ˌjin
言	言	ˌjin
焉	焉	ˌjin
弦	弦	ˌjin
贤	賢	ˌjin
蜒	蜒	ˌjin
研	研	ˌjin
谣	謠	ˌjiu
尧	堯	ˌjiu
瑶	瑤	ˌjiu
摇	搖	ˌjiu
窑	窯	ˌjiu
遥	遙	ˌjiu
洮	洮	ˌjiu
徭	徭	ˌjiu
姚	姚	ˌjiu
娆	嬈	ˌjiu
飖	颻	ˌjiu
饶	饒	ˌjiu
鳐	鰩	ˌjiu
逾	踰	ˌjy
濡	濡	ˌjy
愚	愚	ˌjy
妤	妤	ˌjy
愉	愉	ˌjy
瑜	瑜	ˌjy
竽	竽	ˌjy
予	予	ˌjy
鱼	魚	ˌjy
隅	隅	ˌjy
渝	渝	ˌjy
萸	萸	ˌjy
盂	盂	ˌjy
渔	漁	ˌjy
娱	娛	ˌjy
嚅	嚅	ˌjy
臾	臾	ˌjy
逾	逾	ˌjy
禺	禺	ˌjy
虞	虞	ˌjy
俞	俞	ˌjy
谀	諛	ˌjy
茹	茹	ˌjy
余	餘	ˌjy
觎	覦	ˌjy
榆	榆	ˌjy
蝓	蝓	ˌjy
狳	狳	ˌjy
于	于	ˌjy
蠕	蠕	ˌjy
如	如	ˌjy
余	余	ˌjy
欤	歟	ˌjy
揄	揄	ˌjy
舆	輿	ˌjy
儒	儒	ˌjy
孺	孺	ˌjy/_jy
圆	圓	ˌjyn
芫	芫	ˌjyn
辕	轅	ˌjyn
元	元	ˌjyn
纨	紈	ˌjyn
沅	沅	ˌjyn
完	完	ˌjyn
袁	袁	ˌjyn
原	原	ˌjyn
缘	緣	ˌjyn
员	員	ˌjyn
眩	眩	ˌjyn
悬	懸	ˌjyn
沿	沿	ˌjyn
烷	烷	ˌjyn
铅	鉛	ˌjyn
园	園	ˌjyn
源	源	ˌjyn
玄	玄	ˌjyn
猿	猿	ˌjyn
丸	丸	ˌjyn/´jyn
蕤	蕤	ˌjœy
飏	颺	ˌjœŋ
疡	瘍	ˌjœŋ
烊	烊	ˌjœŋ
羊	羊	ˌjœŋ
杨	楊	ˌjœŋ
徉	徉	ˌjœŋ
瀼	瀼	ˌjœŋ
禳	禳	ˌjœŋ
穰	穰	ˌjœŋ
蘘	蘘	ˌjœŋ
阳	陽	ˌjœŋ
扬	揚	ˌjœŋ
佯	佯	ˌjœŋ
旸	暘	ˌjœŋ
洋	洋	ˌjœŋ
吟	吟	ˌjɐm
任	任	ˌjɐm
霪	霪	ˌjɐm
淫	淫	ˌjɐm
壬	壬	ˌjɐm
人	人	ˌjɐn
夤	夤	ˌjɐn
仁	仁	ˌjɐn
寅	寅	ˌjɐn
铀	鈾	ˌjɐu
游	遊	ˌjɐu
酋	酋	ˌjɐu
揉	揉	ˌjɐu
蚰	蚰	ˌjɐu
油	油	ˌjɐu
攸	攸	ˌjɐu
柔	柔	ˌjɐu
邮	郵	ˌjɐu
疣	疣	ˌjɐu
犹	猶	ˌjɐu
鱿	魷	ˌjɐu
游	游	ˌjɐu
由	由	ˌjɐu
尤	尤	ˌjɐu
蹂	蹂	ˌjɐu
悠	悠	ˌjɐu
耶	耶	ˌjɛ
爷	爺	ˌjɛ
揶	揶	ˌjɛ
椰	椰	ˌjɛ
邪	邪	ˌjɛ
赢	贏	ˌjɛŋ
荥	滎	ˌjɪŋ
蓥	鎣	ˌjɪŋ
迎	迎	ˌjɪŋ
潆	瀠	ˌjɪŋ
盈	盈	ˌjɪŋ
楹	楹	ˌjɪŋ
赢	贏	ˌjɪŋ
邢	邢	ˌjɪŋ
萤	螢	ˌjɪŋ
萦	縈	ˌjɪŋ
莹	瑩	ˌjɪŋ
凝	凝	ˌjɪŋ
营	營	ˌjɪŋ
荧	熒	ˌjɪŋ
型	型	ˌjɪŋ
瀛	瀛	ˌjɪŋ
嬴	嬴	ˌjɪŋ
仍	仍	ˌjɪŋ
蝇	蠅	ˌjɪŋ
刑	刑	ˌjɪŋ
形	形	ˌjɪŋ
陉	陘	ˌjɪŋ
滢	瀅	ˌjɪŋ/_jɪŋ
融	融	ˌjʊŋ
慵	慵	ˌjʊŋ
溶	溶	ˌjʊŋ
鳙	鱅	ˌjʊŋ
容	容	ˌjʊŋ
镛	鏞	ˌjʊŋ
茸	茸	ˌjʊŋ
熔	熔	ˌjʊŋ
蓉	蓉	ˌjʊŋ
佣	傭	ˌjʊŋ
戎	戎	ˌjʊŋ
庸	庸	ˌjʊŋ
榕	榕	ˌjʊŋ
绒	絨	ˌjʊŋ/´jʊŋ
琦	琦	ˌkei
旂	旂	ˌkei
琪	琪	ˌkei
俟	俟	ˌkei
鳍	鰭	ˌkei
耆	耆	ˌkei
蕲	蘄	ˌkei
祁	祁	ˌkei
祺	祺	ˌkei
旗	旗	ˌkei
麒	麒	ˌkei
奇	奇	ˌkei
岐	岐	ˌkei
萁	萁	ˌkei
其	其	ˌkei
祈	祈	ˌkei
淇	淇	ˌkei
歧	歧	ˌkei
棋	棋	ˌkei
期	期	ˌkei
钳	鉗	ˌkim
黔	黔	ˌkim
乾	乾	ˌkin
犍	犍	ˌkin
掮	掮	ˌkin
虔	虔	ˌkin
乔	喬	ˌkiu
侨	僑	ˌkiu
翘	翹	ˌkiu
荞	蕎	ˌkiu
桥	橋	ˌkiu
夔	夔	ˌkwɐi
睽	睽	ˌkwɐi
葵	葵	ˌkwɐi
暌	暌	ˌkwɐi
畦	畦	ˌkwɐi
携	攜	ˌkwɐi
馗	馗	ˌkwɐi
喹	喹	ˌkwɐi
揆	揆	ˌkwɐi/ˏkwɐi
群	群	ˌkwɐn
裙	裙	ˌkwɐn
狂	狂	ˌkwɔŋ
蜷	蜷	ˌkyn
拳	拳	ˌkyn
颧	顴	ˌkyn
权	權	ˌkyn
鬈	鬈	ˌkyn
朐	朐	ˌkœy
渠	渠	ˌkœy
瞿	瞿	ˌkœy
蠼	蠼	ˌkœy
璩	璩	ˌkœy
衢	衢	ˌkœy
强	強	ˌkœŋ
琴	琴	ˌkɐm
禽	禽	ˌkɐm
擒	擒	ˌkɐm
噙	噙	ˌkɐm
勤	勤	ˌkɐn
芹	芹	ˌkɐn
逑	逑	ˌkɐu
虬	虯	ˌkɐu
仇	仇	ˌkɐu
求	求	ˌkɐu
球	球	ˌkɐu
毬	毬	ˌkɐu
裘	裘	ˌkɐu
犰	犰	ˌkɐu
瘸	瘸	ˌkɛ
骑	騎	ˌkɛ
黥	黥	ˌkɪŋ
琼	瓊	ˌkɪŋ
鲸	鯨	ˌkɪŋ
擎	擎	ˌkɪŋ
穹	穹	ˌkʊŋ
邛	邛	ˌkʊŋ
穷	窮	ˌkʊŋ
蓝	藍	ˌlam
岚	嵐	ˌlam
褴	襤	ˌlam
篮	籃	ˌlam
婪	婪	ˌlam
襕	襴	ˌlan
兰	蘭	ˌlan
栏	欄	ˌlan
拦	攔	ˌlan
阑	闌	ˌlan
澜	瀾	ˌlan
斓	斕	ˌlan
梨	梨	ˌlei
缡	縭	ˌlei
璃	璃	ˌlei
篱	籬	ˌlei
狸	狸	ˌlei
罹	罹	ˌlei
厘	釐	ˌlei
离	離	ˌlei
蜊	蜊	ˌlei
鲡	鱺	ˌlei
漓	漓	ˌlei
廉	廉	ˌlim
帘	簾	ˌlim
帘	帘	ˌlim
镰	鐮	ˌlim
涟	漣	ˌlin
连	連	ˌlin
莲	蓮	ˌlin
怜	憐	ˌlin
链	鏈	ˌlin
镣	鐐	ˌliu
寮	寮	ˌliu
瞭	瞭	ˌliu
僚	僚	ˌliu
辽	遼	ˌliu
缭	繚	ˌliu
嘹	嘹	ˌliu
燎	燎	ˌliu
撩	撩	ˌliu
疗	療	ˌliu
聊	聊	ˌliu
獠	獠	ˌliu
寥	寥	ˌliu
芦	蘆	ˌlou
胪	臚	ˌlou
痨	癆	ˌlou
颅	顱	ˌlou
卢	盧	ˌlou
炉	爐	ˌlou
庐	廬	ˌlou
劳	勞	ˌlou
牢	牢	ˌlou
醪	醪	ˌlou
轳	轤	ˌlou
唠	嘮	ˌlou
鲈	鱸	ˌlou
泸	瀘	ˌlou
鸾	鸞	ˌlyn
滦	灤	ˌlyn
峦	巒	ˌlyn
挛	攣	ˌlyn
孪	孿	ˌlyn
联	聯	ˌlyn
栾	欒	ˌlyn
仑	崙	ˌlœn
鳞	鱗	ˌlœn
轮	輪	ˌlœn
遴	遴	ˌlœn
伦	倫	ˌlœn
粼	粼	ˌlœn
抡	掄	ˌlœn
璘	璘	ˌlœn
沦	淪	ˌlœn
仑	侖	ˌlœn
麟	麟	ˌlœn
磷	磷	ˌlœn
论	論	ˌlœn
囵	圇	ˌlœn
纶	綸	ˌlœn
邻	鄰	ˌlœn
嶙	嶙	ˌlœn
驴	驢	ˌlœy
羸	羸	ˌlœy
累	纍	ˌlœy
榈	櫚	ˌlœy
嫘	嫘	ˌlœy
擂	擂	ˌlœy
闾	閭	ˌlœy
镭	鐳	ˌlœy
缧	縲	ˌlœy
雷	雷	ˌlœy
骡	騾	ˌlœy/ˌlɔ
莨	莨	ˌlœŋ
梁	梁	ˌlœŋ
凉	涼	ˌlœŋ
粮	糧	ˌlœŋ
量	量	ˌlœŋ
粱	粱	ˌlœŋ
良	良	ˌlœŋ
黎	黎	ˌlɐi
犂	犂	ˌlɐi
藜	藜	ˌlɐi
犁	犁	ˌlɐi
蠡	蠡	ˌlɐi/ˏlɐi
临	臨	ˌlɐm
林	林	ˌlɐm
啉	啉	ˌlɐm
淋	淋	ˌlɐm
琳	琳	ˌlɐm
霖	霖	ˌlɐm
流	流	ˌlɐu
琉	琉	ˌlɐu
楼	樓	ˌlɐu
硫	硫	ˌlɐu
骝	騮	ˌlɐu
偻	僂	ˌlɐu
髅	髏	ˌlɐu
瘤	瘤	ˌlɐu
捞	撈	ˌlɐu
刘	劉	ˌlɐu
娄	婁	ˌlɐu
留	留	ˌlɐu
浏	瀏	ˌlɐu
榴	榴	ˌlɐu
螻	螻	ˌlɐu
猡	玀	ˌlɔ
箩	籮	ˌlɔ
萝	蘿	ˌlɔ
锣	鑼	ˌlɔ
罗	羅	ˌlɔ
逻	邏	ˌlɔ
螺	螺	ˌlɔ/´lɔ
莱	萊	ˌlɔi
来	來	ˌlɔi
涞	淶	ˌlɔi
崃	崍	ˌlɔi
徕	徠	ˌlɔi
锒	鋃	ˌlɔŋ
榔	榔	ˌlɔŋ
廊	廊	ˌlɔŋ
莨	莨	ˌlɔŋ
郎	郎	ˌlɔŋ
琅	瑯	ˌlɔŋ
螂	螂	ˌlɔŋ
狼	狼	ˌlɔŋ
龄	齡	ˌlɪŋ
令	令	ˌlɪŋ
聆	聆	ˌlɪŋ
陵	陵	ˌlɪŋ
凌	凌	ˌlɪŋ
伶	伶	ˌlɪŋ
苓	苓	ˌlɪŋ
呤	呤	ˌlɪŋ
櫺	櫺	ˌlɪŋ
翎	翎	ˌlɪŋ
囹	囹	ˌlɪŋ
玲	玲	ˌlɪŋ
蛉	蛉	ˌlɪŋ
羚	羚	ˌlɪŋ
棱	稜	ˌlɪŋ
绫	綾	ˌlɪŋ
灵	靈	ˌlɪŋ
菱	菱	ˌlɪŋ
铃	鈴	ˌlɪŋ
零	零	ˌlɪŋ
鲮	鯪	ˌlɪŋ
窿	窿	ˌlʊŋ
胧	朧	ˌlʊŋ
咙	嚨	ˌlʊŋ
眬	矓	ˌlʊŋ
聋	聾	ˌlʊŋ
隆	隆	ˌlʊŋ
龙	龍	ˌlʊŋ
笼	籠	ˌlʊŋ
茏	蘢	ˌlʊŋ
珑	瓏	ˌlʊŋ
昽	曨	ˌlʊŋ
麻	麻	ˌma
蟆	蟆	ˌma
麻	痲	ˌma
埋	埋	ˌmai
霾	霾	ˌmai/ˌmɐi
馒	饅	ˌman
蛮	蠻	ˌman
谩	謾	ˌman
鳗	鰻	ˌman
蔓	蔓	ˌman
茅	茅	ˌmau
矛	矛	ˌmau
盲	盲	ˌmaŋ
眉	眉	ˌmei
湄	湄	ˌmei
蘼	蘼	ˌmei
薇	薇	ˌmei
麋	麋	ˌmei
微	微	ˌmei
楣	楣	ˌmei
嵋	嵋	ˌmei
靡	靡	ˌmei
弥	瀰	ˌmei/ˌnei
猕	獼	ˌmei/ˌnei
绵	綿	ˌmin
棉	棉	ˌmin
眠	眠	ˌmin
苗	苗	ˌmiu
描	描	ˌmiu
瞄	瞄	ˌmiu
模	模	ˌmou
髦	髦	ˌmou
摹	摹	ˌmou
谟	謨	ˌmou
诬	誣	ˌmou
毛	毛	ˌmou
无	無	ˌmou
芜	蕪	ˌmou
毋	毋	ˌmou
膜	膜	ˌmou
巫	巫	ˌmou
牦	氂	ˌmou/ˌlei
玫	玫	ˌmui
霉	霉	ˌmui
媒	媒	ˌmui
煤	煤	ˌmui
酶	酶	ˌmui
梅	梅	ˌmui
枚	枚	ˌmui
莓	莓	ˌmui
们	們	ˌmun
扪	捫	ˌmun
瞒	瞞	ˌmun
门	門	ˌmun
鞔	鞔	ˌmun
迷	迷	ˌmɐi
谜	謎	ˌmɐi
醚	醚	ˌmɐi
眯	瞇	ˌmɐi
苠	苠	ˌmɐn
忞	忞	ˌmɐn
旻	旻	ˌmɐn
岷	岷	ˌmɐn
缗	緡	ˌmɐn
雯	雯	ˌmɐn
珉	珉	ˌmɐn
纹	紋	ˌmɐn
玟	玟	ˌmɐn
氓	氓	ˌmɐn
闻	聞	ˌmɐn
文	文	ˌmɐn
民	民	ˌmɐn
谋	謀	ˌmɐu
眸	眸	ˌmɐu
缪	繆	ˌmɐu
牟	牟	ˌmɐu
萌	萌	ˌmɐŋ
盟	盟	ˌmɐŋ
磨	磨	ˌmɔ
蘑	蘑	ˌmɔ
馍	饃	ˌmɔ
虻	虻	ˌmɔŋ
莽	莽	ˌmɔŋ
茫	茫	ˌmɔŋ
铓	鋩	ˌmɔŋ
忘	忘	ˌmɔŋ
氓	氓	ˌmɔŋ
芒	芒	ˌmɔŋ
亡	亡	ˌmɔŋ
忙	忙	ˌmɔŋ
鸣	鳴	ˌmɪŋ
洺	洺	ˌmɪŋ
冥	冥	ˌmɪŋ
明	明	ˌmɪŋ
溟	溟	ˌmɪŋ
名	名	ˌmɪŋ
螟	螟	ˌmɪŋ
暝	暝	ˌmɪŋ/_mɪŋ
铭	銘	ˌmɪŋ/ˏmɪŋ
瞑	瞑	ˌmɪŋ/ˏmɪŋ
朦	朦	ˌmʊŋ
蒙	矇	ˌmʊŋ
蒙	蒙	ˌmʊŋ
檬	檬	ˌmʊŋ
曚	曚	ˌmʊŋ
蒙	濛	ˌmʊŋ
哪	哪	ˌna
娜	娜	ˌna
南	南	ˌna
拿	拿	ˌna
南	南	ˌnam
囡	囡	ˌnam
男	男	ˌnam
喃	喃	ˌnam
楠	楠	ˌnam
难	難	ˌnan
猱	猱	ˌnau
铙	鐃	ˌnau
锚	錨	ˌnau
挠	撓	ˌnau
桡	橈	ˌnau
尼	尼	ˌnei
怩	怩	ˌnei
铌	鈮	ˌnei
弥	彌	ˌnei
妮	妮	ˌnei
鲇	鯰	ˌnim
年	年	ˌnin
奴	奴	ˌnou
娘	娘	ˌnœŋ
泥	泥	ˌnɐi
呢	呢	ˌnɐi/ˌnei
能	能	ˌnɐŋ
挪	挪	ˌnɔ
挼	挼	ˌnɔ
囔	囔	ˌnɔŋ
囊	囊	ˌnɔŋ
馕	饢	ˌnɔŋ
瓤	瓤	ˌnɔŋ
狞	獰	ˌnɪŋ
宁	寧	ˌnɪŋ
咛	嚀	ˌnɪŋ
柠	檸	ˌnɪŋ
侬	儂	ˌnʊŋ
脓	膿	ˌnʊŋ
农	農	ˌnʊŋ
浓	濃	ˌnʊŋ
爬	爬	ˌpa
杷	杷	ˌpa
耙	耙	ˌpa
扒	扒	ˌpa
琶	琶	ˌpa
排	排	ˌpai
俳	俳	ˌpai
牌	牌	ˌpai
庖	庖	ˌpau
狍	麅	ˌpau
匏	匏	ˌpau
咆	咆	ˌpau
刨	刨	ˌpau
硼	硼	ˌpaŋ
澎	澎	ˌpaŋ
鹏	鵬	ˌpaŋ
彭	彭	ˌpaŋ
膨	膨	ˌpaŋ
棚	棚	ˌpaŋ
脾	脾	ˌpei
疲	疲	ˌpei
琵	琵	ˌpei
貔	貔	ˌpei
枇	枇	ˌpei
蜱	蜱	ˌpei
皮	皮	ˌpei
毗	毗	ˌpei
郫	郫	ˌpei
邳	邳	ˌpei
便	便	ˌpin
骈	駢	ˌpin
嫖	嫖	ˌpiu
瓢	瓢	ˌpiu
朴	朴	ˌpiu
菩	菩	ˌpou
脯	脯	ˌpou
匍	匍	ˌpou
袍	袍	ˌpou
蒲	蒲	ˌpou
莆	莆	ˌpou
葡	葡	ˌpou
赔	賠	ˌpui
裴	裴	ˌpui
培	培	ˌpui
陪	陪	ˌpui
徘	徘	ˌpui
蟠	蟠	ˌpun
盘	盤	ˌpun
磐	磐	ˌpun
盆	盆	ˌpun
槃	槃	ˌpun
蹒	蹣	ˌpun/ˌmun
嫔	嬪	ˌpɐn
频	頻	ˌpɐn
颦	顰	ˌpɐn
贫	貧	ˌpɐn
抔	抔	ˌpɐu
朋	朋	ˌpɐŋ
凭	憑	ˌpɐŋ
婆	婆	ˌpɔ
鄱	鄱	ˌpɔ/¯bɔ
彷	彷	ˌpɔŋ
磅	磅	ˌpɔŋ
旁	旁	ˌpɔŋ
滂	滂	ˌpɔŋ
螃	螃	ˌpɔŋ
膀	膀	ˌpɔŋ
庞	龐	ˌpɔŋ
瓶	瓶	ˌpɪŋ
坪	坪	ˌpɪŋ
评	評	ˌpɪŋ
萍	萍	ˌpɪŋ
平	平	ˌpɪŋ
屏	屏	ˌpɪŋ
苹	蘋	ˌpɪŋ
芃	芃	ˌpʊŋ
篷	篷	ˌpʊŋ
蓬	蓬	ˌpʊŋ/ˌfʊŋ
孱	孱	ˌsan
潺	潺	ˌsan
鲥	鰣	ˌsi
匙	匙	ˌsi
莳	蒔	ˌsi
时	時	ˌsi
禅	禪	ˌsim
单	單	ˌsim
蟾	蟾	ˌsim
蝉	蟬	ˌsin
殊	殊	ˌsy
薯	薯	ˌsy
旋	旋	ˌsyn
船	船	ˌsyn
璇	璇	ˌsyn
漩	漩	ˌsyn
唇	脣	ˌsœn
醇	醇	ˌsœn
淳	淳	ˌsœn
纯	純	ˌsœn
鹑	鶉	ˌsœn/'tsœn
谁	誰	ˌsœy
垂	垂	ˌsœy
尝	嘗	ˌsœŋ
尝	嚐	ˌsœŋ
嫦	嫦	ˌsœŋ
徜	徜	ˌsœŋ
裳	裳	ˌsœŋ
偿	償	ˌsœŋ
常	常	ˌsœŋ
涔	涔	ˌsɐm
岑	岑	ˌsɐm
忱	忱	ˌsɐm
梣	梣	ˌsɐm
辰	辰	ˌsɐn
神	神	ˌsɐn
晨	晨	ˌsɐn
臣	臣	ˌsɐn
仇	仇	ˌsɐu
愁	愁	ˌsɐu
傻	傻	ˌsɔ
蛇	蛇	ˌsɛ
畲	畲	ˌsɛ
城	城	ˌsɪŋ
绳	繩	ˌsɪŋ
诚	誠	ˌsɪŋ
渑	澠	ˌsɪŋ
乘	乘	ˌsɪŋ
盛	盛	ˌsɪŋ
承	承	ˌsɪŋ
成	成	ˌsɪŋ
丞	丞	ˌsɪŋ
崇	崇	ˌsʊŋ
潭	潭	ˌtam
谈	談	ˌtam
昙	曇	ˌtam
澹	澹	ˌtam
谭	譚	ˌtam
郯	郯	ˌtam
痰	痰	ˌtam
覃	覃	ˌtam
坛	壇	ˌtan
檀	檀	ˌtan
弹	彈	ˌtan
恬	恬	ˌtim
甜	甜	ˌtim
填	填	ˌtin
田	田	ˌtin
阗	闐	ˌtin
钿	鈿	ˌtin
滇	滇	ˌtin/'din
钿	鈿	ˌtin/_din
龆	齠	ˌtiu
髫	髫	ˌtiu
笤	笤	ˌtiu
条	條	ˌtiu
调	調	ˌtiu
迢	迢	ˌtiu
鼗	鼗	ˌtou
洮	洮	ˌtou
掏	掏	ˌtou
屠	屠	ˌtou
萄	萄	ˌtou
陶	陶	ˌtou
梼	檮	ˌtou
啕	啕	ˌtou
途	途	ˌtou
涂	塗	ˌtou
涂	涂	ˌtou
涛	濤	ˌtou
荼	荼	ˌtou
淘	淘	ˌtou
逃	逃	ˌtou
图	圖	ˌtou
徒	徒	ˌtou
桃	桃	ˌtou
茬	茬	ˌtsa
碴	碴	ˌtsa
搽	搽	ˌtsa
查	查	ˌtsa
茶	茶	ˌtsa
垞	垞	ˌtsa
槎	槎	ˌtsa
侪	儕	ˌtsai
柴	柴	ˌtsai
豺	豺	ˌtsai
蚕	蠶	ˌtsam
谗	讒	ˌtsam
惭	慚	ˌtsam
馋	饞	ˌtsam
残	殘	ˌtsan
巢	巢	ˌtsau
橙	橙	ˌtsaŋ/´tsaŋ
辞	辭	ˌtsi
祠	祠	ˌtsi
篪	篪	ˌtsi
驰	馳	ˌtsi
慈	慈	ˌtsi
词	詞	ˌtsi
磁	磁	ˌtsi
瓷	瓷	ˌtsi
池	池	ˌtsi
墀	墀	ˌtsi
踟	踟	ˌtsi
糍	糍	ˌtsi
持	持	ˌtsi
匙	匙	ˌtsi
迟	遲	ˌtsi
脐	臍	ˌtsi
茌	茌	ˌtsi
弛	弛	ˌtsi
潜	潛	ˌtsim
前	前	ˌtsin
钱	錢	ˌtsin
缠	纏	ˌtsin
潮	潮	ˌtsiu
朝	朝	ˌtsiu
憔	憔	ˌtsiu
瞧	瞧	ˌtsiu
樵	樵	ˌtsiu
嘈	嘈	ˌtsou
曹	曹	ˌtsou
漕	漕	ˌtsou
槽	槽	ˌtsou
蹰	蹰	ˌtsy
厨	廚	ˌtsy/ˌtsœy
辁	輇	ˌtsyn
筌	筌	ˌtsyn
泉	泉	ˌtsyn
诠	詮	ˌtsyn
存	存	ˌtsyn
铨	銓	ˌtsyn
传	傳	ˌtsyn
荃	荃	ˌtsyn
痊	痊	ˌtsyn
全	全	ˌtsyn
醛	醛	ˌtsyn
驯	馴	ˌtsœn
旬	旬	ˌtsœn
循	循	ˌtsœn
秦	秦	ˌtsœn
巡	巡	ˌtsœn
嗪	嗪	ˌtsœn
螓	螓	ˌtsœn
隋	隋	ˌtsœy
滁	滁	ˌtsœy
随	隨	ˌtsœy
槌	槌	ˌtsœy
徐	徐	ˌtsœy
除	除	ˌtsœy
锤	錘	ˌtsœy
捶	捶	ˌtsœy
蜍	蜍	ˌtsœy
长	長	ˌtsœŋ
蔷	薔	ˌtsœŋ
墙	牆	ˌtsœŋ
祥	祥	ˌtsœŋ
戕	戕	ˌtsœŋ
场	場	ˌtsœŋ
详	詳	ˌtsœŋ
肠	腸	ˌtsœŋ
翔	翔	ˌtsœŋ
樯	檣	ˌtsœŋ
荠	薺	ˌtsɐi
齐	齊	ˌtsɐi
沉	沉	ˌtsɐm
荨	蕁	ˌtsɐm
鲟	鱘	ˌtsɐm
寻	尋	ˌtsɐm
尘	塵	ˌtsɐn
陈	陳	ˌtsɐn
惆	惆	ˌtsɐu
筹	籌	ˌtsɐu
畴	疇	ˌtsɐu
踌	躊	ˌtsɐu
绸	綢	ˌtsɐu
酬	酬	ˌtsɐu
遒	遒	ˌtsɐu
俦	儔	ˌtsɐu
仇	仇	ˌtsɐu
囚	囚	ˌtsɐu
稠	稠	ˌtsɐu
泅	泅	ˌtsɐu
曾	曾	ˌtsɐŋ
层	層	ˌtsɐŋ
锄	鋤	ˌtsɔ
才	才	ˌtsɔi
财	財	ˌtsɔi
裁	裁	ˌtsɔi
材	材	ˌtsɔi
藏	藏	ˌtsɔŋ
床	床	ˌtsɔŋ
輋	輋	ˌtsɛ
邪	邪	ˌtsɛ
斜	斜	ˌtsɛ
呈	呈	ˌtsɪŋ
惩	懲	ˌtsɪŋ
澄	澄	ˌtsɪŋ
情	情	ˌtsɪŋ
程	程	ˌtsɪŋ
晴	晴	ˌtsɪŋ
埕	埕	ˌtsɪŋ
澂	澂	ˌtsɪŋ
重	重	ˌtsʊŋ
丛	叢	ˌtsʊŋ
松	松	ˌtsʊŋ
琮	琮	ˌtsʊŋ
虫	蟲	ˌtsʊŋ
从	從	ˌtsʊŋ
屯	屯	ˌtyn
团	糰	ˌtyn
臀	臀	ˌtyn
豚	豚	ˌtyn
团	團	ˌtyn
囤	囤	ˌtyn
颓	頹	ˌtœy
堤	堤	ˌtɐi
啼	啼	ˌtɐi
鹈	鵜	ˌtɐi
缇	緹	ˌtɐi
醍	醍	ˌtɐi
题	題	ˌtɐi
蹄	蹄	ˌtɐi
提	提	ˌtɐi
头	頭	ˌtɐu
投	投	ˌtɐu
骰	骰	ˌtɐu/'sik
藤	藤	ˌtɐŋ
誊	謄	ˌtɐŋ
疼	疼	ˌtɐŋ
滕	滕	ˌtɐŋ
腾	騰	ˌtɐŋ
沱	沱	ˌtɔ
陀	陀	ˌtɔ
佗	佗	ˌtɔ
驮	馱	ˌtɔ
舵	舵	ˌtɔ
鸵	鴕	ˌtɔ
驼	駝	ˌtɔ
台	台	ˌtɔi
台	枱	ˌtɔi
跆	跆	ˌtɔi
苔	苔	ˌtɔi
台	颱	ˌtɔi
薹	薹	ˌtɔi
抬	抬	ˌtɔi
幢	幢	ˌtɔŋ
螳	螳	ˌtɔŋ
溏	溏	ˌtɔŋ
堂	堂	ˌtɔŋ
棠	棠	ˌtɔŋ
膛	膛	ˌtɔŋ
唐	唐	ˌtɔŋ
醣	醣	ˌtɔŋ
塘	塘	ˌtɔŋ
糖	糖	ˌtɔŋ/´tɔŋ
搪	搪	ˌtɔŋ/ˏtɔŋ
婷	婷	ˌtɪŋ
廷	廷	ˌtɪŋ
庭	庭	ˌtɪŋ
亭	亭	ˌtɪŋ
蜓	蜓	ˌtɪŋ
停	停	ˌtɪŋ
霆	霆	ˌtɪŋ
峒	峒	ˌtʊŋ
潼	潼	ˌtʊŋ
桐	桐	ˌtʊŋ
佟	佟	ˌtʊŋ
瞳	瞳	ˌtʊŋ
彤	彤	ˌtʊŋ
僮	僮	ˌtʊŋ
童	童	ˌtʊŋ
同	同	ˌtʊŋ
酮	酮	ˌtʊŋ
铜	銅	ˌtʊŋ
同	衕	ˌtʊŋ
骅	驊	ˌwa
华	華	ˌwa
划	划	ˌwa/'wa
怀	懷	ˌwai
槐	槐	ˌwai
淮	淮	ˌwai
顽	頑	ˌwan
鬟	鬟	ˌwan
还	還	ˌwan
环	環	ˌwan
寰	寰	ˌwan
玩	玩	ˌwan
横	橫	ˌwaŋ
葫	葫	ˌwu
糊	餬	ˌwu
胡	衚	ˌwu
煳	煳	ˌwu
猢	猢	ˌwu
瑚	瑚	ˌwu
蝴	蝴	ˌwu
狐	狐	ˌwu
湖	湖	ˌwu
壶	壺	ˌwu
胡	鬍	ˌwu
糊	糊	ˌwu
鹕	鶘	ˌwu
醐	醐	ˌwu
胡	胡	ˌwu
弧	弧	ˌwu
洄	洄	ˌwui
回	回	ˌwui
徊	徊	ˌwui
回	迴	ˌwui
蛔	蛔	ˌwui
垣	垣	ˌwun
桓	桓	ˌwun
援	援	ˌwun/ˌjyn
帷	帷	ˌwɐi
唯	唯	ˌwɐi
遗	遺	ˌwɐi
维	維	ˌwɐi
闱	闈	ˌwɐi
潍	濰	ˌwɐi
围	圍	ˌwɐi
惟	惟	ˌwɐi
桅	桅	ˌwɐi
为	為	ˌwɐi
违	違	ˌwɐi
晕	暈	ˌwɐn
筠	筠	ˌwɐn
云	云	ˌwɐn
芸	蕓	ˌwɐn
耘	耘	ˌwɐn
妘	妘	ˌwɐn
匀	勻	ˌwɐn
浑	渾	ˌwɐn
魂	魂	ˌwɐn
云	雲	ˌwɐn
昀	昀	ˌwɐn
馄	餛	ˌwɐn
鋆	鋆	ˌwɐn
芸	芸	ˌwɐn
纭	紜	ˌwɐn
珲	琿	ˌwɐn
宏	宏	ˌwɐŋ
弘	弘	ˌwɐŋ
闳	閎	ˌwɐŋ
禾	禾	ˌwɔ
和	和	ˌwɔ
簧	簧	ˌwɔŋ
潢	潢	ˌwɔŋ
磺	磺	ˌwɔŋ
皇	皇	ˌwɔŋ
惶	惶	ˌwɔŋ
凰	凰	ˌwɔŋ
黄	黃	ˌwɔŋ
遑	遑	ˌwɔŋ
蝗	蝗	ˌwɔŋ
徨	徨	ˌwɔŋ
蟥	蟥	ˌwɔŋ
王	王	ˌwɔŋ
煌	煌	ˌwɔŋ
隍	隍	ˌwɔŋ
荣	榮	ˌwɪŋ
嵘	嶸	ˌwɪŋ
牙	牙	ˌŋa
衙	衙	ˌŋa
芽	芽	ˌŋa
挨	捱	ˌŋai
厓	厓	ˌŋai
睚	睚	ˌŋai
崖	崖	ˌŋai
涯	涯	ˌŋai
岩	岩	ˌŋam
癌	癌	ˌŋam
颜	顏	ˌŋan
肴	餚	ˌŋau
淆	淆	ˌŋau
爻	爻	ˌŋau
螯	螯	ˌŋou
獒	獒	ˌŋou
敖	敖	ˌŋou
翱	翱	ˌŋou
鳌	鰲	ˌŋou
骜	驁	ˌŋou
遨	遨	ˌŋou/_ŋou
熬	熬	ˌŋou/ˌŋɐu
霓	霓	ˌŋɐi
巍	巍	ˌŋɐi
危	危	ˌŋɐi
猊	猊	ˌŋɐi
倪	倪	ˌŋɐi
垠	垠	ˌŋɐn
龈	齦	ˌŋɐn
龂	齗	ˌŋɐn
银	銀	ˌŋɐn
沂	沂	ˌŋɐn
牛	牛	ˌŋɐu
哦	哦	ˌŋɔ
讹	訛	ˌŋɔ
鹅	鵝	ˌŋɔ
峨	峨	ˌŋɔ
娥	娥	ˌŋɔ
俄	俄	ˌŋɔ
蛾	蛾	ˌŋɔ
莪	莪	ˌŋɔ
呆	呆	ˌŋɔi
昂	昂	ˌŋɔŋ
蜈	蜈	ˌŋ̩
吾	吾	ˌŋ̩
梧	梧	ˌŋ̩
吴	吳	ˌŋ̩
鼯	鼯	ˌŋ̩
哦	哦	ˌɔ
掸	撣	ˏdan
掸	撢	ˏdan
这	這	ˏdzɛ/¯dzɛ
妇	婦	ˏfu
忿	忿	ˏfɐn
愤	憤	ˏfɐn
奋	奮	ˏfɐn
獬	獬	ˏhai
蟹	蟹	ˏhai
骇	駭	ˏhai
槛	檻	ˏham
颔	頷	ˏhɐm
厚	厚	ˏhɐu
旱	旱	ˏhɔn
胫	脛	ˏhɪŋ/¯gɪŋ
也	也	ˏja
尔	爾	ˏji
以	以	ˏji
洱	洱	ˏji
矣	矣	ˏji
迤	迤	ˏji
迩	邇	ˏji
已	已	ˏji
议	議	ˏji
耳	耳	ˏji
拟	擬	ˏji
染	染	ˏjim
苒	苒	ˏjim
俨	儼	ˏjim
冉	冉	ˏjim
舀	舀	ˏjiu
予	予	ˏjy
雨	雨	ˏjy
龉	齬	ˏjy
圄	圄	ˏjy
瑀	瑀	ˏjy
羽	羽	ˏjy
语	語	ˏjy
敔	敔	ˏjy
貐	貐	ˏjy
乳	乳	ˏjy
宇	宇	ˏjy
汝	汝	ˏjy
禹	禹	ˏjy
与	與	ˏjy
阮	阮	ˏjyn
软	軟	ˏjyn
远	遠	ˏjyn
蕊	蕊	ˏjœy
氧	氧	ˏjœŋ
攘	攘	ˏjœŋ
仰	仰	ˏjœŋ
养	養	ˏjœŋ
痒	癢	ˏjœŋ
嚷	嚷	ˏjœŋ/_jœŋ
荏	荏	ˏjɐm/_jɐm
蚓	蚓	ˏjɐn
引	引	ˏjɐn
友	友	ˏjɐu
酉	酉	ˏjɐu
有	有	ˏjɐu
诱	誘	ˏjɐu
惹	惹	ˏjɛ
野	野	ˏjɛ
冶	冶	ˏjɛ
郢	郢	ˏjɪŋ
勇	勇	ˏjʊŋ
企	企	ˏkei
跷	蹺	ˏkiu
愧	愧	ˏkwɐi
拒	拒	ˏkœy
距	距	ˏkœy
强	強	ˏkœŋ
羟	羥	ˏkœŋ
妗	妗	ˏkɐm
近	近	ˏkɐn
臼	臼	ˏkɐu/¯kɐu
舅	舅	ˏkɐu/¯kɐu
揽	攬	ˏlam
榄	欖	ˏlam
览	覽	ˏlam
懒	懶	ˏlan
冷	冷	ˏlaŋ
娌	娌	ˏlei
理	理	ˏlei
逦	邐	ˏlei
锂	鋰	ˏlei
鲤	鯉	ˏlei
里	里	ˏlei
俚	俚	ˏlei
李	李	ˏlei
履	履	ˏlei
哩	哩	ˏlei/'jɪŋ/ˏlei
脸	臉	ˏlim
殓	殮	ˏlim
撵	攆	ˏlin
辇	輦	ˏlin
了	瞭	ˏliu
了	了	ˏliu
潦	潦	ˏliu/´liu
掳	擄	ˏlou
卤	鹵	ˏlou
鲁	魯	ˏlou
老	老	ˏlou
姥	姥	ˏlou
卤	滷	ˏlou
橹	櫓	ˏlou
虏	虜	ˏlou
铝	鋁	ˏlœy
磊	磊	ˏlœy
膂	膂	ˏlœy
儡	儡	ˏlœy
里	裡	ˏlœy
缕	縷	ˏlœy
累	累	ˏlœy
屡	屢	ˏlœy
吕	呂	ˏlœy
垒	壘	ˏlœy
旅	旅	ˏlœy
褛	褸	ˏlœy
侣	侶	ˏlœy
蕾	蕾	ˏlœy/ˌlœy
魉	魎	ˏlœŋ
两	兩	ˏlœŋ
俩	倆	ˏlœŋ
鳢	鱧	ˏlɐi
醴	醴	ˏlɐi
澧	澧	ˏlɐi
礼	禮	ˏlɐi
凛	凜	ˏlɐm
懔	懍	ˏlɐm
篓	簍	ˏlɐu
柳	柳	ˏlɐu
朗	朗	ˏlɔŋ
岭	嶺	ˏlɪŋ/ˏlɛŋ
领	領	ˏlɪŋ/ˏlɛŋ
陇	隴	ˏlʊŋ
垄	壟	ˏlʊŋ
笼	籠	ˏlʊŋ
拢	攏	ˏlʊŋ
玛	瑪	ˏma
码	碼	ˏma
犸	獁	ˏma
蚂	螞	ˏma
马	馬	ˏma
买	買	ˏmai
荬	蕒	ˏmai
晚	晚	ˏman
卯	卯	ˏmau
铆	鉚	ˏmau
锰	錳	ˏmaŋ
猛	猛	ˏmaŋ
蜢	蜢	ˏmaŋ
勐	勐	ˏmaŋ
美	美	ˏmei
镁	鎂	ˏmei
媺	媺	ˏmei
娓	娓	ˏmei
尾	尾	ˏmei
勉	勉	ˏmin
腼	靦	ˏmin
免	免	ˏmin
娩	娩	ˏmin
冕	冕	ˏmin
缅	緬	ˏmin
杳	杳	ˏmiu
渺	渺	ˏmiu
淼	淼	ˏmiu
藐	藐	ˏmiu
邈	邈	ˏmiu
秒	秒	ˏmiu
缈	緲	ˏmiu
姆	姆	ˏmou
侮	侮	ˏmou
武	武	ˏmou
舞	舞	ˏmou
拇	拇	ˏmou
母	母	ˏmou
鹉	鵡	ˏmou
妩	嫵	ˏmou
每	每	ˏmui
满	滿	ˏmun
螨	蟎	ˏmun
米	米	ˏmɐi
鳘	鰵	ˏmɐn
闽	閩	ˏmɐn
刎	刎	ˏmɐn
悯	憫	ˏmɐn
渑	澠	ˏmɐn
闵	閔	ˏmɐn
愍	愍	ˏmɐn
敏	敏	ˏmɐn
黾	黽	ˏmɐn
吻	吻	ˏmɐn
泯	泯	ˏmɐn
抿	抿	ˏmɐn
湣	湣	ˏmɐn
亩	畝	ˏmɐu
某	某	ˏmɐu
牡	牡	ˏmɐu
妄	妄	ˏmɔŋ
辋	輞	ˏmɔŋ
罔	罔	ˏmɔŋ
魍	魍	ˏmɔŋ
网	網	ˏmɔŋ
惘	惘	ˏmɔŋ
蟒	蟒	ˏmɔŋ
酩	酩	ˏmɪŋ
皿	皿	ˏmɪŋ
茗	茗	ˏmɪŋ/ˌmɪŋ
蠓	蠓	ˏmʊŋ
懵	懵	ˏmʊŋ/´mʊŋ
哪	哪	ˏna
那	那	ˏna
乃	乃	ˏnai
氖	氖	ˏnai
奶	奶	ˏnai
鼐	鼐	ˏnai
腩	腩	ˏnam
赧	赧	ˏnan
你	你	ˏnei
旎	旎	ˏnei
你	妳	ˏnei
您	您	ˏnei
碾	碾	ˏnin
袅	裊	ˏniu
鸟	鳥	ˏniu
脑	腦	ˏnou
瑙	瑙	ˏnou
恼	惱	ˏnou
弩	弩	ˏnou
努	努	ˏnou/ˏlou
暖	暖	ˏnyn
钕	釹	ˏnœy
馁	餒	ˏnœy
女	女	ˏnœy/ˏlœy
稔	稔	ˏnɐm
馕	饢	ˏnɔŋ
棒	棒	ˏpaŋ
婢	婢	ˏpei
被	被	ˏpei
鳔	鰾	ˏpiu
瞟	瞟	ˏpiu
抱	抱	ˏpou
泡	泡	ˏpou
倍	倍	ˏpui
蓓	蓓	ˏpui/ˌpui
睥	睥	ˏpɐi
牝	牝	ˏpɐn
蚌	蚌	ˏpɔŋ
市	市	ˏsi
鳝	鱔	ˏsin
隽	雋	ˏsyn
吮	吮	ˏsyn
墅	墅	ˏsœy
髓	髓	ˏsœy
绪	緒	ˏsœy
絮	絮	ˏsœy/_sœy
上	上	ˏsœŋ
舐	舐	ˏsɐi/´sɐi
肾	腎	ˏsɐn
社	社	ˏsɛ
淡	淡	ˏtam
殄	殄	ˏtin/ˏtim
窕	窕	ˏtiu
挑	挑	ˏtiu
肚	肚	ˏtou
恃	恃	ˏtsi
柿	柿	ˏtsi
似	似	ˏtsi
践	踐	ˏtsin/_dzin
曙	曙	ˏtsy
处	處	ˏtsy
署	署	ˏtsy
伫	佇	ˏtsy
褚	褚	ˏtsy
柱	柱	ˏtsy
苎	苧	ˏtsy
储	儲	ˏtsy
坐	坐	ˏtsɔ
重	重	ˏtsʊŋ
断	斷	ˏtyn
盾	盾	ˏtœn
挺	挺	ˏtɪŋ
铤	鋌	ˏtɪŋ
艇	艇	ˏtɪŋ/ˏtɛŋ
踝	踝	ˏwa
挽	挽	ˏwan
挽	輓	ˏwan
会	會	ˏwui
浣	浣	ˏwun
皖	皖	ˏwun
韦	韋	ˏwɐi
纬	緯	ˏwɐi
苇	葦	ˏwɐi
玮	瑋	ˏwɐi
讳	諱	ˏwɐi
韪	韙	ˏwɐi
伟	偉	ˏwɐi
殒	殞	ˏwɐn
尹	尹	ˏwɐn
狁	狁	ˏwɐn
陨	隕	ˏwɐn
允	允	ˏwɐn
往	往	ˏwɔŋ
永	永	ˏwɪŋ
雅	雅	ˏŋa
佤	佤	ˏŋa
瓦	瓦	ˏŋa
眼	眼	ˏŋan
咬	咬	ˏŋau
蚁	蟻	ˏŋɐi
藕	藕	ˏŋɐu
偶	偶	ˏŋɐu
我	我	ˏŋɔ
午	午	ˏŋ̩
忤	忤	ˏŋ̩
五	五	ˏŋ̩
牾	牾	ˏŋ̩
伍	伍	ˏŋ̩
