開放粵語字典（粵語拼音字調符調號版）

© 2013年 kaifangcidian.com
網址：http://www.kaifangcidian.com
本字典以創作共用“署名 3.0”許可協議授權發佈（詳見 http://creativecommons.org/licenses/by/3.0/）
最後更新於2013年1月22日

［繁體字］	［簡體字］	［粵語拼音］

罷	罢	bà
吧	吧	bà
茇	茇	bàd
帛	帛	bàg
白	白	bàg
匐	匐	bàg
蔔	卜	bàg
稗	稗	bài
敗	败	bài
辦	办	bàn
扮	扮	bàn
蹦	蹦	bàng
繃	绷	bàng
笨	笨	bànt
鈸	钹	bàt
弼	弼	bàt
拔	拔	bàt
菝	菝	bàt
苾	苾	bàt
跋	跋	bàt
齙	龅	bàu
鮑	鲍	bàu
陛	陛	bày
幣	币	bày
弊	弊	bày
敝	敝	bày
斃	毙	bày
狴	狴	bày
壩	坝	bâ
霸	霸	bâ
捌	捌	bâd
八	八	bâd
佰	佰	bâg
百	百	bâg
伯	伯	bâg
拜	拜	bâi
扮	扮	bân
擯	摈	bânt
殯	殡	bânt
鬢	鬓	bânt
爆	爆	bâu
贔	赑	bây
蔽	蔽	bây
閉	闭	bây
鈀	钯	bã
把	把	bã
靶	靶	bã
襬	摆	bãi
擺	摆	bãi
捭	捭	bãi
舨	舨	bãn
版	版	bãn
坂	坂	bãn
闆	板	bãn
板	板	bãn
品	品	bãnt
稟	禀	bãnt
飽	饱	bãu
芭	芭	bä
笆	笆	bä
爸	爸	bä
葩	葩	bä
粑	粑	bä
疤	疤	bä
叭	叭	bä
巴	巴	bä
迫	迫	bäg/bëk
掰	掰	bäi/mâg
北	北	bäk
泵	泵	bämp
乓	乓	bämp/pöng
班	班	bän
斑	斑	bän
瘢	瘢	bän
頒	颁	bän
鏰	镚	bänk
崩	崩	bänk
斌	斌	bänt
彬	彬	bänt
繽	缤	bänt
賓	宾	bänt
奔	奔	bänt
濱	滨	bänt
檳	槟	bänt
瀕	濒	bänt/pant
篳	筚	bät
蓽	荜	bät
蹕	跸	bät
畢	毕	bät
筆	笔	bät
不	不	bät
嗶	哔	bät
鈈	钚	bät
胞	胞	bäu
孢	孢	bäu
鮑	鲍	bäu
包	包	bäu
苞	苞	bäu
褒	褒	bäu
跛	跛	bäy/bõ
唄	呗	bè
病	病	bèng/bènk
並	并	bènk
箆	箆	bèy
鼻	鼻	bèy
備	备	bèy
被	被	bèy
避	避	bèy
憊	惫	bèy/bài
柄	柄	bêng/bênk
迸	迸	bênk
併	并	bênk/pênk
秘	秘	bêy
庇	庇	bêy
轡	辔	bêy
鉍	铋	bêy
痺	痹	bêy
臂	臂	bêy
泌	泌	bêy
啤	啤	bë
逼	逼	bëk
碧	碧	bëk
壁	壁	bëk
璧	璧	bëk
愎	愎	bëk
冰	冰	bënk
兵	兵	bënk
乒	乒	bënk/pënk
碑	碑	bëy
悲	悲	bëy
裨	裨	bëy
卑	卑	bëy
屄	屄	bëy
蹩	蹩	bìd
別	别	bìd
癟	瘪	bìd
辯	辩	bìn
辨	辨	bìn
便	便	bìn
卞	卞	bìn
鱉	鳖	bîd
彆	别	bîd
憋	憋	bîd
變	变	bîn
觱	觱	bïd
必	必	bïd
辮	辫	bïn
邊	边	bïn
鞭	鞭	bïn
錶	表	bïu
標	标	bïu
鑣	镳	bïu
鏢	镖	bïu
飆	飙	bïu
膘	膘	bïu
彪	彪	bïu
箔	箔	bòg
礴	礴	bòg
鉑	铂	bòg
薄	薄	bòg
泊	泊	bòg
雹	雹	bòg
舶	舶	bòg/pâg
蹼	蹼	bòk
僕	仆	bòk
曝	曝	bòk
瀑	瀑	bòk
濮	濮	bòk
磅	磅	bòng
傍	傍	bòng
鎊	镑	bòng
步	步	bòw
捕	捕	bòw
部	部	bòw
暴	暴	bòw
哺	哺	bòw
簿	簿	bòw
埠	埠	bòw/fàw
簸	簸	bô
播	播	bô
博	博	bôg
亳	亳	bôg
膊	膊	bôg
駁	驳	bôg
搏	搏	bôg
縛	缚	bôg/fôg
甭	甭	bônk
怖	怖	bôw
報	报	bôw
埔	埔	bôw
布	布	bôw
佈	布	bôw
蒡	蒡	bõng
綁	绑	bõng
榜	榜	bõng
膀	膀	bõng
堡	堡	bõw
鴇	鸨	bõw
保	保	bõw
圃	圃	bõw
寶	宝	bõw
補	补	bõw
葆	葆	bõw
玻	玻	bö
菠	菠	bö
波	波	bö
卜	卜	bök
邦	邦	böng
梆	梆	böng
幫	帮	böng
晡	晡	böw
勃	勃	bùd
撥	拨	bùd
脖	脖	bùd
荸	荸	bùd
渤	渤	bùd
焙	焙	bùi
悖	悖	bùi
背	背	bùi
絆	绊	bùn
畔	畔	bùn
叛	叛	bùn
胖	胖	bùn
拌	拌	bùn
伴	伴	bùn/pũn
缽	钵	bûd
鋇	钡	bûi
輩	辈	bûi
揹	背	bûi
狽	狈	bûi
貝	贝	bûi
半	半	bûn
杯	杯	büi
般	般	bün
搬	搬	bün
匾	匾	bĩn
貶	贬	bĩn
扁	扁	bĩn
婊	婊	bĩu
表	表	bĩu
畚	畚	bũn
苯	苯	bũn
本	本	bũn
餅	饼	bẽng
秉	秉	bẽnk
炳	炳	bẽnk
餅	饼	bẽnk
丙	丙	bẽnk
屏	屏	bẽnk
妣	妣	bẽy
比	比	bẽy
彼	彼	bẽy
匕	匕	bẽy/bêy
搽	搽	ca
槎	槎	ca
垞	垞	ca
茬	茬	ca
查	查	ca
碴	碴	ca
茶	茶	ca
豺	豺	cai
柴	柴	cai
儕	侪	cai
蠶	蚕	cam
饞	馋	cam
慚	惭	cam
讒	谗	cam
沉	沉	camp
蕁	荨	camp
鱘	鲟	camp
尋	寻	camp
殘	残	can
橙	橙	cang/cãng
曾	曾	cank
層	层	cank
塵	尘	cant
陳	陈	cant
巢	巢	cau
遒	遒	caw
囚	囚	caw
籌	筹	caw
泅	泅	caw
仇	仇	caw
稠	稠	caw
躊	踌	caw
疇	畴	caw
惆	惆	caw
酬	酬	caw
儔	俦	caw
綢	绸	caw
齊	齐	cay
薺	荠	cay
輋	輋	ce
斜	斜	ce
邪	邪	ce
情	情	cenk
澂	澂	cenk
埕	埕	cenk
澄	澄	cenk
懲	惩	cenk
呈	呈	cenk
程	程	cenk
晴	晴	cenk
腸	肠	ceong
場	场	ceong
長	长	ceong
戕	戕	ceong
祥	祥	ceong
牆	墙	ceong
薔	蔷	ceong
詳	详	ceong
翔	翔	ceong
檣	樯	ceong
蹰	蹰	ceu
廚	厨	ceu/coy
荃	荃	ceun
全	全	ceun
輇	辁	ceun
痊	痊	ceun
醛	醛	ceun
筌	筌	ceun
泉	泉	ceun
詮	诠	ceun
存	存	ceun
傳	传	ceun
銓	铨	ceun
戳	戳	ceôg
綽	绰	ceôg
卓	卓	ceôg
嗆	呛	ceông
戧	戗	ceông
悵	怅	ceông
蹌	跄	ceông
熗	炝	ceông
唱	唱	ceông
倡	倡	ceông
暢	畅	ceông
搶	抢	ceõng
嗆	呛	ceöng
戧	戗	ceöng
窗	窗	ceöng
鏘	锵	ceöng
菖	菖	ceöng
倀	伥	ceöng
娼	娼	ceöng
鯧	鲳	ceöng
猖	猖	ceöng
昌	昌	ceöng
槍	枪	ceöng
佇	伫	ceú
署	署	ceú
柱	柱	ceú
儲	储	ceú
苧	苎	ceú
處	处	ceú
褚	褚	ceú
曙	曙	ceú
處	处	ceû
踅	踅	ceûd
猝	猝	ceûd
撮	撮	ceûd
爨	爨	ceûn
串	串	ceûn
竄	窜	ceûn
寸	寸	ceûn
吋	吋	ceûn
櫥	橱	ceü
躇	躇	ceü
躥	蹿	ceün
村	村	ceün
汆	汆	ceün
川	川	ceün
穿	穿	ceün
貯	贮	ceũ
杵	杵	ceũ
忖	忖	ceũn
喘	喘	ceũn
揣	揣	ceũn
攛	撺	ceũn/ceûn
辭	辞	ci
踟	踟	ci
茌	茌	ci
臍	脐	ci
遲	迟	ci
匙	匙	ci
持	持	ci
瓷	瓷	ci
祠	祠	ci
篪	篪	ci
馳	驰	ci
慈	慈	ci
糍	糍	ci
弛	弛	ci
墀	墀	ci
池	池	ci
詞	词	ci
磁	磁	ci
潛	潜	cim
前	前	cin
纏	缠	cin
錢	钱	cin
憔	憔	ciu
瞧	瞧	ciu
潮	潮	ciu
樵	樵	ciu
朝	朝	ciu
鋤	锄	co
材	材	coi
才	才	coi
財	财	coi
裁	裁	coi
床	床	cong
藏	藏	cong
蟲	虫	conk
從	从	conk
叢	丛	conk
松	松	conk
琮	琮	conk
重	重	conk
嗪	嗪	cont
螓	螓	cont
秦	秦	cont
馴	驯	cont
巡	巡	cont
旬	旬	cont
循	循	cont
曹	曹	cow
嘈	嘈	cow
槽	槽	cow
漕	漕	cow
徐	徐	coy
蜍	蜍	coy
錘	锤	coy
隨	随	coy
隋	隋	coy
滁	滁	coy
除	除	coy
捶	捶	coy
槌	槌	coy
鰂	鲗	càg
賊	贼	càg
鋥	锃	càng
岔	岔	câ
詫	诧	câ
杈	杈	câ
衩	衩	câ
姹	姹	câ
插	插	câb
鍤	锸	câb
擦	擦	câd
刷	刷	câd
察	察	câd
獺	獭	câd
剎	刹	câd/sâd
柵	栅	câg
策	策	câg
拆	拆	câg
冊	册	câg
蠆	虿	câi
懺	忏	câm
杉	杉	câm/säm
讖	谶	câmp/câm
璨	璨	cân
燦	灿	cân
襯	衬	cânt
齔	龀	cânt
趁	趁	cânt
肏	肏	câu
嗅	嗅	câw
臭	臭	câw
湊	凑	câw
糗	糗	câw
溴	溴	câw
切	切	cây
沏	沏	cây
砌	砌	cây
踩	踩	cãi
踹	踹	cãi
慘	惨	cãm
磣	碜	cãmp
寢	寝	cãmp
產	产	cãn
鏟	铲	cãn
哂	哂	cãnt
診	诊	cãnt
縝	缜	cãnt/jãnt
炒	炒	cãu
吵	吵	cãu
醜	丑	cãw
丑	丑	cãw
差	差	cä
叉	叉	cä
搋	搋	cäi
差	差	cäi
揣	揣	cäi
猜	猜	cäi
釵	钗	cäi
惻	恻	cäk
測	测	cäk
攙	搀	cäm
摻	掺	cäm
參	参	cäm
侵	侵	cämp
參	参	cämp/cäm
餐	餐	cän
撐	撑	cäng
瞠	瞠	cäng
嗔	嗔	cänt
瞋	瞋	cänt
親	亲	cänt
輯	辑	cäp
緝	缉	cäp
葺	葺	cäp
七	七	cät
漆	漆	cät
柒	柒	cät
鈔	钞	cäu
抄	抄	cäu
楸	楸	cäw
鰍	鳅	cäw
抽	抽	cäw
鞦	秋	cäw
秋	秋	cäw
棲	栖	cäy
妻	妻	cäy
淒	凄	cäy
悽	悽	cäy
赤	赤	cêg
尺	尺	cêg
呎	呎	cêg
秤	秤	cênk
稱	称	cênk
稱	称	cênk/cânk
車	车	cë
奢	奢	cë
叱	叱	cëk
敕	敕	cëk
斥	斥	cëk
戚	戚	cëk
彳	彳	cëk
清	清	cënk
氰	氰	cënk
稱	称	cënk
鯖	鲭	cënk
蜻	蜻	cënk
蟶	蛏	cënk
青	青	cënk/cëng
似	似	cí
恃	恃	cí
柿	柿	cí
踐	践	cín/jìn
幟	帜	cî
廁	厕	cî
熾	炽	cî
翅	翅	cî
賜	赐	cî
次	次	cî
刺	刺	cî
妾	妾	cîb
設	设	cîd
撤	撤	cîd
澈	澈	cîd
轍	辙	cîd
切	切	cîd
徹	彻	cîd
掣	掣	cîd
塹	堑	cîm
僭	僭	cîm
暹	暹	cîm/cïm
肖	肖	cîu
鞘	鞘	cîu
俏	俏	cîu
峭	峭	cîu
雌	雌	cï
嗤	嗤	cï
差	差	cï
哧	哧	cï
眵	眵	cï
螭	螭	cï
蚩	蚩	cï
笞	笞	cï
鴟	鸱	cï
跐	跐	cï
魑	魑	cï
疵	疵	cï
癡	痴	cï
簽	签	cïm
籤	签	cïm
纖	纤	cïm
殲	歼	cïm
韆	千	cïn
仟	仟	cïn
遷	迁	cïn
千	千	cïn
阡	阡	cïn
超	超	cïu
釗	钊	cïu
昭	昭	cïu
鍬	锹	cïu
坐	坐	có
重	重	cónk
挫	挫	cô
錯	错	cô
銼	锉	cô
錯	错	côg
菜	菜	côi
賽	赛	côi
蔡	蔡	côi
塞	塞	côi
創	创	công
躁	躁	côw
噪	噪	côw
糙	糙	côw
醋	醋	côw
燥	燥	côw
措	措	côw
操	操	côw/cöw
覷	觑	côy
趣	趣	côy
翠	翠	côy
啐	啐	côy
脆	脆	côy
焠	焠	côy/sòy
淬	淬	côy/sòy
楚	楚	cõ
礎	础	cõ
綵	彩	cõi
採	采	cõi
睬	睬	cõi
采	采	cõi
彩	彩	cõi
闖	闯	cõng
敞	敞	cõng
氅	氅	cõng
廠	厂	cõng
寵	宠	cõnk
冢	冢	cõnk
蠢	蠢	cõnt
草	草	cõw
娶	娶	cõy
取	取	cõy
揣	揣	cõy
搓	搓	cö
芻	刍	cö
磋	磋	cö
雛	雏	cö
初	初	cö
齪	龊	cök
蹴	蹴	cök
亍	亍	cök
畜	畜	cök
蹙	蹙	cök
矗	矗	cök
束	束	cök
簇	簇	cök
蓄	蓄	cök
促	促	cök
速	速	cök
簌	簌	cök
搐	搐	cök
觸	触	cök/jök
蒼	苍	cöng
滄	沧	cöng
傖	伧	cöng
艙	舱	cöng
倉	仓	cöng
創	创	cöng
瘡	疮	cöng
忡	忡	cönk
衝	冲	cönk
聰	聪	cönk
驄	骢	cönk
沖	冲	cönk
樅	枞	cönk
囪	囱	cönk
憧	憧	cönk
匆	匆	cönk
涌	涌	cönk
充	充	cönk
蔥	葱	cönk
春	春	cönt
齣	出	cöt
出	出	cöt
操	操	cöw
粗	粗	cöw
催	催	cöy
趨	趋	cöy
炊	炊	cöy
摧	摧	cöy
吹	吹	cöy
崔	崔	cöy
璀	璀	cöy/cõy
褫	褫	cĩ
跐	跐	cĩ
矢	矢	cĩ
豕	豕	cĩ
侈	侈	cĩ
恥	耻	cĩ
始	始	cĩ
齒	齿	cĩ
此	此	cĩ
諂	谄	cĩm
淺	浅	cĩn
悄	悄	cĩu
悄	悄	cĩu/cïu
且	且	cẽ
扯	扯	cẽ
逞	逞	cẽnk
拯	拯	cẽnk
騁	骋	cẽnk
請	请	cẽnk/cẽng
斲	斫	deôg
涿	涿	deôg
啄	啄	deôg
琢	琢	deôg
奪	夺	deùd
段	段	deùn
斷	断	deùn
緞	缎	deùn
斷	断	deùn/deûn
鍛	锻	deûn
煅	煅	deûn
端	端	deün
短	短	deũn
沓	沓	dàb
踏	踏	dàb
蹋	蹋	dàb
達	达	dàd
噠	哒	dàd
繨	繨	dàd
大	大	dài
特	特	dàk
氮	氮	dàm
淡	淡	dàm
澹	澹	dàm
淡	淡	dàm/tám
疍	疍	dàn
憚	惮	dàn
蛋	蛋	dàn
但	但	dàn
彈	弹	dàn
鄧	邓	dànk
瞪	瞪	dànk/dänk
燉	炖	dànt
突	突	dàt
凸	凸	dàt
竇	窦	dàw
痘	痘	dàw
逗	逗	dàw
豆	豆	dàw/dãw
悌	悌	dày
弟	弟	dày
隸	隶	dày
第	第	dày
遞	递	dày
棣	棣	dày
逮	逮	dày/dòi
撢	掸	dán
撣	掸	dán
耷	耷	dâb
答	答	dâb
瘩	瘩	dâb
搭	搭	dâb
靼	靼	dâd
妲	妲	dâd/tãn
帶	带	dâi
戴	戴	dâi
誕	诞	dân
旦	旦	dân
鐙	镫	dânk
凳	凳	dânk
磴	磴	dânk
鬥	斗	dâw
締	缔	dây
帝	帝	dây
碲	碲	dây
蒂	蒂	dây
諦	谛	dây
打	打	dã
歹	歹	dãi
膽	胆	dãm
彈	弹	dãn
等	等	dãnk
墩	墩	dãnt
陡	陡	dãw
斗	斗	dãw
蚪	蚪	dãw
抖	抖	dãw
底	底	dãy
骶	骶	dãy
詆	诋	dãy
柢	柢	dãy
邸	邸	dãy
抵	抵	dãy
呆	呆	däi
德	德	däk
得	得	däk
聃	聃	däm
儋	儋	däm
耽	耽	däm
眈	眈	däm
擔	担	däm
單	单	dän
丹	丹	dän
殫	殚	dän
鄲	郸	dän
噔	噔	dänk
燈	灯	dänk
蹬	蹬	dänk
登	登	dänk
兜	兜	däw
低	低	däy
糴	籴	dèg
笛	笛	dèg
敵	敌	dèk
狄	狄	dèk
翟	翟	dèk
迪	迪	dèk
滌	涤	dèk
啶	啶	dènk
定	定	dènk
地	地	dèy
碇	碇	dênk
錠	锭	dênk/dènk
訂	订	dênk/dènk
爹	爹	dë
嫡	嫡	dëk
滴	滴	dëk
的	的	dëk
町	町	dënk
仃	仃	dënk
汀	汀	dënk
丁	丁	dënk
盯	盯	dënk/dëng
釘	钉	dënk/dëng
叮	叮	dënk/dëng
喋	喋	dìb
蝶	蝶	dìb
鰈	鲽	dìb
諜	谍	dìb
疊	叠	dìb
碟	碟	dìb
牒	牒	dìb
耋	耋	dìd
秩	秩	dìd
迭	迭	dìd
澱	淀	dìn
佃	佃	dìn
電	电	dìn
靛	靛	dìn
甸	甸	dìn
奠	奠	dìn
殿	殿	dìn
墊	垫	dìn
調	调	dìu
掉	掉	dìu
跌	跌	dîd
踮	踮	dîm
店	店	dîm
惦	惦	dîm
玷	玷	dîm
墊	垫	dîn
釣	钓	dîu
弔	吊	dîu
吊	吊	dîu
掂	掂	dïm
顛	颠	dïn
巔	巅	dïn
癲	癫	dïn
碘	碘	dïn
刁	刁	dïu
貂	貂	dïu
丟	丢	dïu
碉	碉	dïu
叼	叼	dïu
凋	凋	dïu
雕	雕	dïu
鯛	鲷	dïu
惰	惰	dò
墮	堕	dò
馱	驮	dò
度	度	dòg
踱	踱	dòg
鐸	铎	dòg
袋	袋	dòi
黛	黛	dòi
靆	叇	dòi
代	代	dòi
玳	玳	dòi
待	待	dòi
岱	岱	dòi
甙	甙	dòi
怠	怠	dòi/tói
殆	殆	dòi/tói
讀	读	dòk
碡	碡	dòk
櫝	椟	dòk
犢	犊	dòk
毒	毒	dòk
瀆	渎	dòk
黷	黩	dòk
牘	牍	dòk
獨	独	dòk
髑	髑	dòk
宕	宕	dòng
盪	荡	dòng
蕩	荡	dòng
碭	砀	dòng
菪	菪	dòng
胴	胴	dònk
慟	恸	dònk
恫	恫	dònk
侗	侗	dònk
洞	洞	dònk
動	动	dònk
頓	顿	dònt
鈍	钝	dònt
遁	遁	dònt
沌	沌	dònt
盹	盹	dònt
噸	吨	dònt
渡	渡	dòw
悼	悼	dòw
盜	盗	dòw
稻	稻	dòw
杜	杜	dòw
導	导	dòw
道	道	dòw
度	度	dòw
鍍	镀	dòw
蹈	蹈	dòw
兌	兑	dòy
隊	队	dòy
當	当	dông
檔	档	dông
棟	栋	dônk
凍	冻	dônk
蠹	蠹	dôw
妒	妒	dôw
到	到	dôw
倒	倒	dôw
對	对	dôy
跺	跺	dõ
躲	躲	dõ
朵	朵	dõ/deãu
剁	剁	dõ/deôg
黨	党	dõng
擋	挡	dõng
董	董	dõnk
懂	懂	dõnk
踵	踵	dõnk
島	岛	dõw
睹	睹	dõw
賭	赌	dõw
倒	倒	dõw
搗	捣	dõw
堵	堵	dõw
多	多	dö
哆	哆	dö
篤	笃	dök
督	督	dök
當	当	döng
鐺	铛	döng
噹	当	döng
襠	裆	döng
氡	氡	dönk
東	东	dönk
咚	咚	dönk
冬	冬	dönk
蹲	蹲	dönt
墩	墩	dönt
惇	惇	dönt
敦	敦	dönt
咄	咄	döt
叨	叨	döw
嘟	嘟	döw
刀	刀	döw
都	都	döw
堆	堆	döy
點	点	dĩm
碘	碘	dĩn
墊	垫	dĩn
典	典	dĩn
屌	屌	dĩu
嗲	嗲	dẽ
鼎	鼎	dẽnk
酊	酊	dẽnk
頂	顶	dẽnk
欸	欸	ey
礬	矾	fan
蕃	蕃	fan
凡	凡	fan
繁	繁	fan
樊	樊	fan
煩	烦	fan
釩	钒	fan
藩	藩	fan
帆	帆	fan
梵	梵	fan/fàn
焚	焚	fant
墳	坟	fant
汾	汾	fant
浮	浮	faw
腓	腓	fey
肥	肥	fey
妨	妨	fong
防	防	fong
房	房	fong
縫	缝	fonk
馮	冯	fonk
逢	逢	fonk
縫	缝	fonk/fònk
扶	扶	fu
符	符	fu
乎	乎	fu
芙	芙	fu
犯	犯	fàn
飯	饭	fàn
范	范	fàn
範	范	fàn
瓣	瓣	fàn
分	分	fànt
份	份	fànt
乏	乏	fàt
閥	阀	fàt
筏	筏	fàt
罰	罚	fàt
伐	伐	fàt
佛	佛	fàt
阜	阜	fàw
吠	吠	fày
忿	忿	fánt
憤	愤	fánt
奮	奋	fánt
化	化	fâ
琺	珐	fâd
髮	发	fâd
發	发	fâd
法	法	fâd
筷	筷	fâi
傀	傀	fâi
塊	块	fâi
快	快	fâi
噲	哙	fâi
泛	泛	fân/fàn
販	贩	fân/fãn
訓	训	fânt
糞	粪	fânt
沸	沸	fây
狒	狒	fây
費	费	fây
廢	废	fây
肺	肺	fây
犯	犯	fãn
返	返	fãn
反	反	fãn
粉	粉	fãnt
否	否	fãw
花	花	fä
旛	旛	fän
番	番	fän
翻	翻	fän
幡	幡	fän
分	分	fänt
婚	婚	fänt
紛	纷	fänt
熏	熏	fänt
燻	熏	fänt
醺	醺	fänt
昏	昏	fänt
葷	荤	fänt
氛	氛	fänt
勳	勋	fänt
吩	吩	fänt
芬	芬	fänt
酚	酚	fänt
薰	薰	fänt
拂	拂	fät
囫	囫	fät
弗	弗	fät
忽	忽	fät
窟	窟	fät
笏	笏	fät
彿	佛	fät
惚	惚	fät
氟	氟	fät
暉	晖	fäy
揮	挥	fäy
輝	辉	fäy
徽	徽	fäy
撝	撝	fäy
啡	啡	fë
扉	扉	fëy
緋	绯	fëy
鯡	鲱	fëy
菲	菲	fëy
蜚	蜚	fëy
非	非	fëy
飛	飞	fëy
妃	妃	fëy
霏	霏	fëy
伏	伏	fòk
茯	茯	fòk
宓	宓	fòk
復	复	fòk
袱	袱	fòk
服	服	fòk
奉	奉	fònk
鳳	凤	fònk
俸	俸	fònk/fõnk
課	课	fô
貨	货	fô
攫	攫	fôg
霍	霍	fôg
放	放	fông
況	况	fông
諷	讽	fônk
伙	伙	fõ
夥	伙	fõ
火	火	fõ
顆	颗	fõ
幌	幌	fõng
晃	晃	fõng
恍	恍	fõng
彷	仿	fõng
訪	访	fõng
仿	仿	fõng
紡	纺	fõng
蝌	蝌	fö
科	科	fö
蝠	蝠	fök
覆	覆	fök
福	福	fök
輻	辐	fök
幅	幅	fök
馥	馥	fök
蝮	蝮	fök
複	复	fök
腹	腹	fök
芳	芳	föng
慌	慌	föng
坊	坊	föng
謊	谎	föng
肪	肪	föng
邡	邡	föng
方	方	föng
荒	荒	föng
風	风	fönk
豐	丰	fönk
蜂	蜂	fönk
封	封	fönk
瘋	疯	fönk
烽	烽	fönk
鋒	锋	fönk
峰	峰	fönk
楓	枫	fönk
丰	丰	fönk
腐	腐	fù
赴	赴	fù
仆	仆	fù
駙	驸	fù
鮒	鲋	fù
傅	傅	fù
訃	讣	fù
咐	咐	fù
負	负	fù
附	附	fù
輔	辅	fù
父	父	fù
付	付	fù
婦	妇	fú
戽	戽	fû
絝	绔	fû
富	富	fû
褲	裤	fû
庫	库	fû
副	副	fû
賦	赋	fû
闊	阔	fûd
晦	晦	fûi
悔	悔	fûi
誨	诲	fûi
孵	孵	fü
俘	俘	fü
枯	枯	fü
呼	呼	fü
麩	麸	fü
軤	轷	fü
膚	肤	fü
骷	骷	fü
敷	敷	fü
夫	夫	fü
孚	孚	fü
灰	灰	füi
恢	恢	füi
魁	魁	füi
詼	诙	füi
奎	奎	füi/kuäy
寬	宽	fün
歡	欢	fün
髖	髋	fün
貛	獾	fün
苦	苦	fũ
府	府	fũ
虎	虎	fũ
斧	斧	fũ
撫	抚	fũ
腑	腑	fũ
唬	唬	fũ
甫	甫	fũ
俯	俯	fũ
琥	琥	fũ
拊	拊	fũ
釜	釜	fũ
鮪	鲔	fũi
款	款	fũn
榧	榧	fẽy
誹	诽	fẽy
匪	匪	fẽy
翡	翡	fẽy
斐	斐	fẽy
悱	悱	fẽy
強	强	geòng
腳	脚	geôg
殭	僵	geöng
羌	羌	geöng
僵	僵	geöng
蜣	蜣	geöng
薑	姜	geöng
姜	姜	geöng
疆	疆	geöng
韁	缰	geöng
倦	倦	geùn
券	券	geûn
眷	眷	geûn
鄄	鄄	geûn
絹	绢	geûn
鵑	鹃	geün
蠲	蠲	geün
涓	涓	geün
娟	娟	geün
捐	捐	geün
捲	卷	geũn
卷	卷	geũn
郡	郡	guànt
珺	珺	guànt
倔	倔	guàt
掘	掘	guàt
崛	崛	guàt
簣	篑	guày
櫃	柜	guày
跪	跪	guày
饋	馈	guày
褂	褂	guâ
掛	挂	guâ
卦	卦	guâ
刮	刮	guâd
颳	刮	guâd
摑	掴	guâg
怪	怪	guâi
摜	掼	guân
慣	惯	guân
棍	棍	guânt
桂	桂	guây
季	季	guây
悸	悸	guây
癸	癸	guây
貴	贵	guây
瑰	瑰	guây
寡	寡	guã
柺	柺	guãi
蒯	蒯	guãi
拐	拐	guãi
滾	滚	guãnt
晷	晷	guãy
鬼	鬼	guãy
軌	轨	guãy
詭	诡	guãy
瓜	瓜	guä
呱	呱	guä
乖	乖	guäi
鰥	鳏	guän
關	关	guän
訇	訇	guänk
肱	肱	guänk
薨	薨	guänk
轟	轰	guänk
鯤	鲲	guänt
軍	军	guänt
鋆	鋆	guänt
綸	纶	guänt
筠	筠	guänt
均	均	guänt
錕	锟	guänt
鈞	钧	guänt
君	君	guänt
骨	骨	guät
橘	橘	guät
鮭	鲑	guäy
圭	圭	guäy
硅	硅	guäy
瑰	瑰	guäy
龜	龟	guäy
閨	闺	guäy
皈	皈	guäy
歸	归	guäy
虢	虢	guëk
隙	隙	guëk/kuënk
過	过	guô
國	国	guôg
郭	郭	guôg
幗	帼	guôg
膕	腘	guôg
廓	廓	guôg/kuôg
桄	桄	guông
果	果	guõ
裹	裹	guõ
誑	诳	guõng
廣	广	guõng
獷	犷	guõng
戈	戈	guö
胱	胱	guöng
光	光	guöng
桄	桄	guöng
炯	炯	guẽnk
迥	迥	guẽnk
近	近	gànt
疙	疙	gàt
舊	旧	gàw
價	价	gâ
架	架	gâ
駕	驾	gâ
嫁	嫁	gâ
假	假	gâ
稼	稼	gâ
咖	咖	gâ
胛	胛	gâb
郟	郏	gâb
岬	岬	gâb
夾	夹	gâb
莢	荚	gâb
餄	饸	gâb
袷	袷	gâb
頰	颊	gâb
鉀	钾	gâb
蛺	蛱	gâb
甲	甲	gâb
軋	轧	gâd
鎘	镉	gâg
格	格	gâg
胳	胳	gâg
嗝	嗝	gâg
隔	隔	gâg
膈	膈	gâg
骼	骼	gâg
革	革	gâg
介	介	gâi
解	解	gâi
屆	届	gâi
疥	疥	gâi
尬	尬	gâi
界	界	gâi
戒	戒	gâi
誡	诫	gâi
芥	芥	gâi
鑑	鉴	gâm
監	监	gâm
淦	淦	gâmp
贛	赣	gâmp
噤	噤	gâmp
禁	禁	gâmp
澗	涧	gân
間	间	gân
諫	谏	gân
更	更	gânk
艮	艮	gânt
靳	靳	gânt
覲	觐	gânt/gãnt
蛤	蛤	gâp
鴿	鸽	gâp
嘎	嘎	gât
鉸	铰	gâu
校	校	gâu
教	教	gâu
較	较	gâu
覺	觉	gâu
窖	窖	gâu
酵	酵	gâu/häu
究	究	gâw
柩	柩	gâw
疚	疚	gâw
救	救	gâw
咎	咎	gâw
夠	够	gâw
詬	诟	gâw
垢	垢	gâw
廄	厩	gâw
灸	灸	gâw
計	计	gây
繼	继	gây
髻	髻	gây
薊	蓟	gây
尕	尕	gã
賈	贾	gã
斝	斝	gã
假	假	gã
檟	槚	gã
架	架	gã
解	解	gãi
蚧	蚧	gãi/guãi
減	减	gãm
橄	橄	gãmp
敢	敢	gãmp
錦	锦	gãmp
感	感	gãmp
揀	拣	gãn
柬	柬	gãn
簡	简	gãn
繭	茧	gãn
鹼	碱	gãn
鐧	锏	gãn
哽	哽	gãnk
埂	埂	gãnk
梗	梗	gãnk
亙	亘	gãnk
耿	耿	gãnk
鯁	鲠	gãnk/kãnk
謹	谨	gãnt
緊	紧	gãnt
堇	堇	gãnt
僅	仅	gãnt
饉	馑	gãnt
瑾	瑾	gãnt
搞	搞	gãu
餃	饺	gãu
狡	狡	gãu
姣	姣	gãu
皎	皎	gãu
攪	搅	gãu
佼	佼	gãu
絞	绞	gãu
鉸	铰	gãu
苟	苟	gãw
韭	韭	gãw
枸	枸	gãw
玖	玖	gãw
九	九	gãw
久	久	gãw
狗	狗	gãw
糾	纠	gãw/dãw
珈	珈	gä
迦	迦	gä
加	加	gä
袈	袈	gä
伽	伽	gä
噶	噶	gä
嘉	嘉	gä
痂	痂	gä
鎵	镓	gä
傢	家	gä
枷	枷	gä
家	家	gä
佳	佳	gäi
階	阶	gäi
街	街	gäi
偕	偕	gäi
秸	秸	gäi
皆	皆	gäi
緘	缄	gäm
監	监	gäm
尷	尴	gäm/gâm
今	今	gämp
柑	柑	gämp
金	金	gämp
泔	泔	gämp
甘	甘	gämp
禁	禁	gämp
苷	苷	gämp
間	间	gän
艱	艰	gän
奸	奸	gän
姦	奸	gän
更	更	gäng
耕	耕	gäng
羹	羹	gänk
更	更	gänk
庚	庚	gänk
斤	斤	gänt
巾	巾	gänt
哏	哏	gänt
根	根	gänt
跟	跟	gänt
筋	筋	gänt
急	急	gäp
紇	纥	gät
吉	吉	gät
桔	桔	gät
訖	讫	gät
跤	跤	gäu
膠	胶	gäu
茭	茭	gäu
郊	郊	gäu
交	交	gäu
蛟	蛟	gäu
鉤	钩	gäw
佝	佝	gäw
鬮	阄	gäw
鳩	鸠	gäw/käw
雞	鸡	gäy
極	极	gèk
痙	痉	gènk
競	竞	gènk
勁	劲	gènk
忌	忌	gèy
伎	伎	gèy
技	技	gèy
芰	芰	gèy
妓	妓	gèy
鏡	镜	gêng
敬	敬	gênk
徑	径	gênk
勁	劲	gênk
逕	径	gênk
覬	觊	gêy
記	记	gêy
既	既	gêy
寄	寄	gêy
紀	纪	gêy
棘	棘	gëk
激	激	gëk
殛	殛	gëk
戟	戟	gëk
亟	亟	gëk
擊	击	gëk
驚	惊	gëng
矜	矜	gënk
經	经	gënk
涇	泾	gënk
兢	兢	gënk
荊	荆	gënk
驚	惊	gënk
京	京	gënk
磯	矶	gëy
犄	犄	gëy
姬	姬	gëy
畸	畸	gëy
譏	讥	gëy
奇	奇	gëy
箕	箕	gëy
乩	乩	gëy
基	基	gëy
飢	饥	gëy
嘰	叽	gëy
覊	羁	gëy
几	几	gëy
璣	玑	gëy
機	机	gëy
幾	几	gëy
肌	肌	gëy
畿	畿	gëy
傑	杰	gìd
桀	桀	gìd
儉	俭	gìm
鍵	键	gìn
件	件	gìn
健	健	gìn
撬	撬	gìu
轎	轿	gìu
劫	劫	gîb
結	结	gîd
拮	拮	gîd
潔	洁	gîd
劍	剑	gîm
見	见	gîn
建	建	gîn
腱	腱	gîn
叫	叫	gîu
搛	搛	gïm
兼	兼	gïm
鶼	鹣	gïm
犍	犍	gïn
肩	肩	gïn
堅	坚	gïn
驕	骄	gïu
嬌	娇	gïu
鋦	锔	gòk
局	局	gòk
焗	焗	gòk
共	共	gònk
誥	诰	gòw
懼	惧	gòy
颶	飓	gòy
詎	讵	gòy
苣	苣	gòy
遽	遽	gòy
具	具	gòy
鉅	巨	gòy
巨	巨	gòy
炬	炬	gòy
個	个	gô
葛	葛	gôd
割	割	gôd
各	各	gôg
角	角	gôg
擱	搁	gôg
閣	阁	gôg
覺	觉	gôg
蓋	盖	gôi
幹	干	gôn
鋼	钢	gông
槓	杠	gông
降	降	gông
絳	绛	gông
供	供	gônk
貢	贡	gônk
郜	郜	gôw
告	告	gôw
鋯	锆	gôw
踞	踞	gôy
據	据	gôy
句	句	gôy
鋸	锯	gôy/geô
改	改	gõi
擀	擀	gõn
桿	杆	gõn
趕	赶	gõn
港	港	gõng
講	讲	gõng
拱	拱	gõnk
鞏	巩	gõnk
珙	珙	gõnk
杲	杲	gõw
藁	藁	gõw
稿	稿	gõw
槁	槁	gõw
縞	缟	gõw
鎬	镐	gõw
齲	龋	gõy
舉	举	gõy
矩	矩	gõy
櫸	榉	gõy
蒟	蒟	gõy
莒	莒	gõy
歌	歌	gö
哥	哥	gö
仡	仡	gö
旮	旮	gö/gôg
菏	菏	gö/ho
咯	咯	gög
該	该	göi
賅	赅	göi
轂	毂	gök
菊	菊	gök
嚳	嚳	gök
鵠	鹄	gök
穀	谷	gök
掬	掬	gök
鞠	鞠	gök
梏	梏	gök
谷	谷	gök
竿	竿	gön
肝	肝	gön
杆	杆	gön
乾	干	gön
干	干	gön
綱	纲	göng
罡	罡	göng
剛	刚	göng
崗	岗	göng
岡	冈	göng
江	江	göng
缸	缸	göng
肛	肛	göng
弓	弓	gönk
工	工	gönk
功	功	gönk
宮	宫	gönk
公	公	gönk
躬	躬	gönk
龔	龚	gönk
供	供	gönk
恭	恭	gönk
蚣	蚣	gönk
攻	攻	gönk
睾	睾	göw
皋	皋	göw
羔	羔	göw
膏	膏	göw
高	高	göw
糕	糕	göw
据	据	göy
居	居	göy
僱	雇	gû
故	故	gû
顧	顾	gû
固	固	gû
錮	锢	gû
盥	盥	gûn
冠	冠	gûn
灌	灌	gûn
貫	贯	gûn
罐	罐	gûn
鸛	鹳	gûn
觚	觚	gü
咕	咕	gü
軲	轱	gü
蛄	蛄	gü
沽	沽	gü
姑	姑	gü
菇	菇	gü
辜	辜	gü
孤	孤	gü
棺	棺	gün
倌	倌	gün
莞	莞	gün
觀	观	gün
冠	冠	gün
官	官	gün
瞼	睑	gĩm
撿	捡	gĩm
檢	检	gĩm
矯	矫	gĩu
繳	缴	gĩu
古	古	gũ
估	估	gũ
鈷	钴	gũ
賈	贾	gũ
牯	牯	gũ
股	股	gũ
蠱	蛊	gũ
鼓	鼓	gũ
館	馆	gũn
管	管	gũn
脘	脘	gũn
莞	莞	gũn
頸	颈	gẽng
境	境	gẽnk
警	警	gẽnk
竟	竟	gẽnk
儆	儆	gẽnk
憬	憬	gẽnk
景	景	gẽnk
璟	璟	gẽnk
紀	纪	gẽy
己	己	gẽy
幾	几	gẽy
杞	杞	gẽy
遐	遐	ha
霞	霞	ha
瑕	瑕	ha
蛤	蛤	ha
骸	骸	hai
諧	谐	hai
鞋	鞋	hai
孩	孩	hai
函	函	ham
銜	衔	ham
咸	咸	ham
涵	涵	ham
鹹	咸	ham
酣	酣	hamp
晗	晗	hamp
含	含	hamp
嫺	娴	han
閒	闲	han
癇	痫	han
行	行	hang
桁	桁	hank
恆	恒	hank
衡	衡	hank
行	行	hank
痕	痕	hant
瘊	瘊	haw
篌	篌	haw
喉	喉	haw
侯	侯	haw
猴	猴	haw
奚	奚	hay
兮	兮	hay
鼷	鼷	hay
向	向	heông
嚮	向	heông
享	享	heõng
晌	晌	heõng
餉	饷	heõng
饗	飨	heõng
響	响	heõng
靴	靴	heö
鄉	乡	heöng
香	香	heöng
血	血	heûd
勸	劝	heûn
絢	绚	heûn
綣	绻	heûn
券	券	heûn
萱	萱	heün
喧	喧	heün
圈	圈	heün
壎	埙	heün
暄	暄	heün
畎	畎	heũn
犬	犬	heũn
荷	荷	ho
河	河	ho
何	何	ho
汗	汗	hon
韓	韩	hon
寒	寒	hon
邯	邯	hon
鼾	鼾	hon
降	降	hong
杭	杭	hong
航	航	hong
吭	吭	hong
行	行	hong
虹	虹	honk
洪	洪	honk
雄	雄	honk
紅	红	honk
鴻	鸿	honk
熊	熊	honk
訌	讧	honk/hônk
號	号	how
嚎	嚎	how
嗥	嗥	how
壕	壕	how
蠔	蠔	how
豪	豪	how
毫	毫	how
廈	厦	hà
暇	暇	hà
下	下	hà
夏	夏	hà
篋	箧	hàb
磕	磕	hàb
峽	峡	hàb
匣	匣	hàb
頜	颌	hàb
瞌	瞌	hàb
柙	柙	hàb
合	合	hàb
盒	盒	hàb
闔	阖	hàb
狎	狎	hàb
俠	侠	hàb/hàb
狹	狭	hàb/hâb
解	解	hài
懈	懈	hài
械	械	hài
邂	邂	hài/hái
餡	馅	hàm
陷	陷	hàm
撼	撼	hàmp
憾	憾	hàmp
限	限	hàn
行	行	hànk
杏	杏	hànk
悻	悻	hànk
幸	幸	hànk
倖	幸	hànk
恨	恨	hànt
轄	辖	hàt
齕	龁	hàt
瞎	瞎	hàt
紇	纥	hàt
劾	劾	hàt
閡	阂	hàt
檄	檄	hàt
核	核	hàt/wàt
傚	傚	hàu
效	效	hàu
校	校	hàu
効	効	hàu
鱟	鲎	hàw
后	后	hàw
候	候	hàw
逅	逅	hàw
後	后	hàw
系	系	hày
繫	系	hày
係	系	hày
獬	獬	hái
駭	骇	hái
蟹	蟹	hái
檻	槛	hám
頷	颔	hámp
厚	厚	háw
掐	掐	hâb
呷	呷	hâb
嗑	嗑	hâb
嚇	吓	hâg
客	客	hâg
喊	喊	hâm
瞰	瞰	hâmp
勘	勘	hâmp
磡	磡	hâmp
崁	崁	hâmp
嵌	嵌	hâmp/hàmp
孝	孝	hâu
吼	吼	hâw
坎	坎	hãmp
砍	砍	hãmp
肯	肯	hãnk
啃	啃	hãnk
懇	恳	hãnt
很	很	hãnt
狠	狠	hãnt
墾	垦	hãnt
考	考	hãu
拷	拷	hãu
巧	巧	hãu
口	口	hãw
蝦	虾	hä
哈	哈	hä
恰	恰	häb
洽	洽	häb
赫	赫	häg
嗨	嗨	häi
揩	揩	häi
黑	黑	häk
剋	克	häk
刻	刻	häk
可	可	häk
克	克	häk
氪	氪	häk
勘	勘	hämp
蚶	蚶	hämp
憨	憨	hämp
龕	龛	hämp
堪	堪	hämp
戡	戡	hämp
坑	坑	häng
夯	夯	häng
哼	哼	hänk
鏗	铿	hänk
亨	亨	hänk
莖	茎	hänk/gênk
乞	乞	hät
敲	敲	häu
哮	哮	häu
烤	烤	häu/hãu
齁	齁	häw
脛	胫	hénk/gênk
吃	吃	hêg
慶	庆	hênk
興	兴	hênk
磬	磬	hênk
罄	罄	hênk
戲	戏	hêy
汽	汽	hêy
氣	气	hêy
憩	憩	hêy
器	器	hêy
棄	弃	hêy
興	兴	hënk
卿	卿	hënk
氫	氢	hënk
兄	兄	hënk
馨	馨	hënk
輕	轻	hënk/hëng
熹	熹	hëy
希	希	hëy
嘻	嘻	hëy
唏	唏	hëy
欺	欺	hëy
欷	欷	hëy
浠	浠	hëy
嬉	嬉	hëy
醯	醯	hëy
羲	羲	hëy
禧	禧	hëy
烯	烯	hëy
稀	稀	hëy
犧	牺	hëy
曦	曦	hëy
熙	熙	hëy
嘿	嘿	hëy
愜	惬	hìb
協	协	hîb
脅	胁	hîb
怯	怯	hîb
歉	歉	hîb
挾	挟	hîb/hàb
歇	歇	hîd
蠍	蝎	hîd
芡	芡	hîm
欠	欠	hîm
獻	献	hîn
憲	宪	hîn
竅	窍	hîu/kîu
謙	谦	hïm
牽	牵	hïn
騫	骞	hïn
軒	轩	hïn
掀	掀	hïn
驍	骁	hïu
澆	浇	hïu
囂	嚣	hïu
梟	枭	hïu
鴞	鸮	hïu
僥	侥	hïu
橇	橇	hïu/côy
賀	贺	hò
荷	荷	hò
貉	貉	hòg
鶴	鹤	hòg
學	学	hòg
氦	氦	hòi
害	害	hòi
亥	亥	hòi
槲	槲	hòk
酷	酷	hòk
汗	汗	hòn
捍	捍	hòn
翰	翰	hòn
焊	焊	hòn
瀚	瀚	hòn
悍	悍	hòn
項	项	hòng
巷	巷	hòng/hõng
號	号	hòw
鎬	镐	hòw
皓	皓	hòw
灝	灏	hòw
浩	浩	hòw
昊	昊	hòw
旱	旱	hón
鞨	鞨	hôd
喝	喝	hôd
褐	褐	hôd
渴	渴	hôd
殼	壳	hôg
漢	汉	hôn
看	看	hôn
哄	哄	hônk
汞	汞	hônk
控	控	hônk
鬨	哄	hônk/hònk
烘	烘	hônk/hönk
犒	犒	hôw
好	好	hôw
耗	耗	hôw
去	去	hôy
可	可	hõ
嗬	嗬	hõ
坷	坷	hõ
岢	岢	hõ
海	海	hõi
凱	凯	hõi
鎧	铠	hõi
剴	剀	hõi
愷	恺	hõi
塏	垲	hõi
闓	闿	hõi
罕	罕	hõn
侃	侃	hõn
刊	刊	hõn/hön
慷	慷	hõng/kõng
恐	恐	hõnk
孔	孔	hõnk
好	好	hõw
栩	栩	hõy
詡	诩	hõy
許	许	hõy
煦	煦	hõy/hôy
訶	诃	hö
呵	呵	hö
苛	苛	hö
開	开	höi
咍	咍	höi
鐦	锎	höi
哭	哭	hök
糠	糠	höng
誆	诓	höng
劻	劻	höng
腔	腔	höng
匡	匡	höng
康	康	höng
眶	眶	höng/kuäng
筐	筐	höng/kuäng
凶	凶	hönk
洶	汹	hönk
胸	胸	hönk
崆	崆	hönk
空	空	hönk
匈	匈	hönk
兇	凶	hönk
箜	箜	hönk
蒿	蒿	höw
薅	薅	höw
盱	盱	höy
歔	歔	höy
虛	虚	höy
噓	嘘	höy
墟	墟	höy
吁	吁	höy
險	险	hĩm
譴	谴	hĩn
繾	缱	hĩn
顯	显	hĩn
遣	遣	hĩn
蜆	蚬	hĩn
曉	晓	hĩu
哼	哼	hǹg
喜	喜	hẽy
豈	岂	hẽy
囍	囍	hẽy
起	起	hẽy
著	着	jeòg
著	著	jeòg
象	象	jeòng
杖	杖	jeòng
仗	仗	jeòng
像	像	jeòng
橡	橡	jeòng
匠	匠	jeòng
丈	丈	jeòng
雀	雀	jeôg
著	着	jeôg
鵲	鹊	jeôg
爵	爵	jeôg
嚼	嚼	jeôg
斫	斫	jeôg
灼	灼	jeôg
酌	酌	jeôg
勺	勺	jeôg/ceôg
桌	桌	jeôg/ceôg
醬	酱	jeông
幛	幛	jeông
瘴	瘴	jeông
障	障	jeông
嶂	嶂	jeông
賬	账	jeông
將	将	jeông
脹	胀	jeông
漲	涨	jeông
帳	帐	jeông
仗	仗	jeông
槳	桨	jeõng
獎	奖	jeõng
掌	掌	jeõng
長	长	jeõng
蔣	蒋	jeõng
漲	涨	jeõng/jeông
彰	彰	jeöng
將	将	jeöng
章	章	jeöng
漿	浆	jeöng
張	张	jeöng
漳	漳	jeöng
璋	璋	jeöng
蟑	蟑	jeöng
獐	獐	jeöng
樟	樟	jeöng
鄣	鄣	jeöng
嫜	嫜	jeöng
住	住	jeù
箸	箸	jeù
絕	绝	jeùd
傳	传	jeùn
著	著	jeû
駐	驻	jeû
注	注	jeû
註	注	jeû
著	著	jeû
蛀	蛀	jeû
炷	炷	jeû
啜	啜	jeûd
掇	掇	jeûd
輟	辍	jeûd
拙	拙	jeûd
咄	咄	jeûd
茁	茁	jeûd
轉	转	jeûn
鑽	钻	jeûn
鑽	钻	jeûn/jeün
豬	猪	jeü
株	株	jeü
蛛	蛛	jeü
侏	侏	jeü
珠	珠	jeü
銖	铢	jeü
茱	茱	jeü
誅	诛	jeü
諸	诸	jeü
朱	朱	jeü
磚	砖	jeün
尊	尊	jeün
顓	颛	jeün
專	专	jeün
鱒	鳟	jeün/jeûn
鐫	镌	jeün/jônt
煮	煮	jeũ
主	主	jeũ
傳	传	jeũn
纂	纂	jeũn
轉	转	jeũn
嵖	嵖	jà
膪	膪	jà
襲	袭	jàb
閘	闸	jàb
習	习	jàb
雜	杂	jàb
什	什	jàb
隰	隰	jàb
集	集	jàb
澤	泽	jàg
擇	择	jàg
摘	摘	jàg
躑	踯	jàg
擲	掷	jàg
謫	谪	jàg
宅	宅	jàg
眥	眦	jài
寨	寨	jài
站	站	jàm
鏨	錾	jàm
暫	暂	jàm
鴆	鸩	jàmp
朕	朕	jàmp
棧	栈	jàn
綻	绽	jàn
撰	撰	jàn
饌	馔	jàn
賺	赚	jàn
掙	挣	jàng
贈	赠	jànk
陣	阵	jànt
姪	侄	jàt
窒	窒	jàt
桎	桎	jàt
蟄	蛰	jàt
蛭	蛭	jàt
嫉	嫉	jàt
疾	疾	jàt
岫	岫	jàw
宙	宙	jàw
紂	纣	jàw
就	就	jàw
袖	袖	jàw
鷲	鹫	jàw
驟	骤	jàw
冑	冑	jàw
滯	滞	jày
炸	炸	jâ
詐	诈	jâ
乍	乍	jâ
咋	咋	jâ
榨	榨	jâ
咤	咤	jâ
蚱	蚱	jâ/jâg
咂	咂	jâb
眨	眨	jâb
砸	砸	jâb
匝	匝	jâb
札	札	jâd
扎	扎	jâd
軋	轧	jâd
紮	紮	jâd
鍘	铡	jâd
拶	拶	jâd
嘖	啧	jâg
責	责	jâg
窄	窄	jâg
債	债	jâi
湛	湛	jâm
蘸	蘸	jâm
枕	枕	jâmp
浸	浸	jâmp
讚	赞	jân
贊	赞	jân
鎮	镇	jânt
震	震	jânt
圳	圳	jânt
振	振	jânt
賑	赈	jânt
罩	罩	jâu
晝	昼	jâw
縐	绉	jâw
皺	皱	jâw
奏	奏	jâw
揍	揍	jâw
咒	咒	jâw
祭	祭	jây
製	制	jây
掣	掣	jây
際	际	jây
霽	霁	jây
濟	济	jây
制	制	jây
斬	斩	jãm
嶄	崭	jãm
怎	怎	jãmp
枕	枕	jãmp
盞	盏	jãn
趲	趱	jãn
攢	攒	jãn
疹	疹	jãnt
軫	轸	jãnt/cãnt
爪	爪	jãu
找	找	jãu
走	走	jãw
帚	帚	jãw
肘	肘	jãw
酒	酒	jãw
濟	济	jãy
仔	仔	jãy
咱	咱	jä
糌	糌	jä
吒	吒	jä
渣	渣	jä
齇	齇	jä
楂	楂	jä
抓	抓	jä/jãu
齎	赍	jäi
齋	斋	jäi
側	侧	jäk
則	则	jäk
仄	仄	jäk
昃	昃	jäk
斟	斟	jämp
箴	箴	jämp
針	针	jämp
砧	砧	jämp
簪	簪	jämp
增	增	jänk
崢	峥	jänk
錚	铮	jänk
僧	僧	jänk
憎	憎	jänk
曾	曾	jänk
箏	筝	jänk
猙	狰	jänk/jäng
掙	挣	jänk/jäng
爭	争	jänk/jäng
睜	睁	jänk/jäng
珍	珍	jänt
胗	胗	jänt
真	真	jänt
汁	汁	jäp
執	执	jäp
質	质	jät
嘲	嘲	jäu
鄒	邹	jäw
輈	辀	jäw
週	周	jäw
揪	揪	jäw
謅	诌	jäw
州	州	jäw
周	周	jäw
舟	舟	jäw
諏	诹	jäw
洲	洲	jäw
陬	陬	jäw
擠	挤	jäy
劑	剂	jäy
齏	齑	jäy
躋	跻	jäy
謝	谢	jè
汐	汐	jèk
席	席	jèk
夕	夕	jèk
寂	寂	jèk
籍	籍	jèk
殖	殖	jèk
直	直	jèk
藉	藉	jèk
值	值	jèk
矽	矽	jèk
植	植	jèk
蓆	蓆	jèk/jèg
藉	借	jèk/jê
借	借	jèk/jê
鄭	郑	jèng/jènk
淨	净	jènk
靜	静	jènk
靖	靖	jènk
阱	阱	jènk/jèng
這	这	jé/jê
柘	柘	jê
借	借	jê
蔗	蔗	jê
隻	只	jêg
瘠	瘠	jêk
炙	炙	jêk/jêg
脊	脊	jêk/jêg
政	政	jênk
正	正	jênk
證	证	jênk
症	症	jênk
嗟	嗟	jë
遮	遮	jë
績	绩	jëk
積	积	jëk
即	即	jëk
織	织	jëk
跡	迹	jëk
鯽	鲫	jëk
職	职	jëk
陟	陟	jëk
稷	稷	jëk
漬	渍	jëk/jî
鉦	钲	jënk
癥	症	jënk
烝	烝	jënk
睛	睛	jënk
蒸	蒸	jënk
偵	侦	jënk
菁	菁	jënk
貞	贞	jënk
征	征	jënk
怔	怔	jënk
徵	征	jënk
正	正	jënk
禎	祯	jënk
精	精	jënk
旌	旌	jënk
晶	晶	jënk
字	字	jì
雉	雉	jì
治	治	jì
巳	巳	jì
伺	伺	jì
耜	耜	jì
嗣	嗣	jì
稚	稚	jì
祀	祀	jì
自	自	jì
俟	俟	jì
痔	痔	jì
飼	饲	jì
峙	峙	jì/cí
豸	豸	jì/jài
寺	寺	jì/jĩ
捷	捷	jìd
睫	睫	jìd
截	截	jìd
漸	渐	jìm
賤	贱	jìn
召	召	jìu
趙	赵	jìu
質	质	jî
誌	志	jî
痣	痣	jî
智	智	jî
摯	挚	jî
志	志	jî
緻	致	jî
至	至	jî
輊	轾	jî
致	致	jî
置	置	jî
躓	踬	jî
恣	恣	jî/cî
輒	辄	jîb
摺	折	jîb
楫	楫	jîb
褶	褶	jîb
接	接	jîb
浹	浃	jîb
囁	嗫	jîb
櫛	栉	jîd
婕	婕	jîd
折	折	jîd
節	节	jîd
哲	哲	jîd
蜇	蜇	jîd
癤	疖	jîd
浙	浙	jîd
佔	占	jîm
顫	颤	jîn
薦	荐	jîn
餞	饯	jîn
戰	战	jîn
濺	溅	jîn
箭	箭	jîn
詔	诏	jîu
照	照	jîu
氏	氏	jï
蜘	蜘	jï
脂	脂	jï
支	支	jï
枝	枝	jï
咨	咨	jï
滋	滋	jï
孜	孜	jï
茲	兹	jï
姿	姿	jï
淄	淄	jï
鼒	鼒	jï
資	资	jï
貲	赀	jï
知	知	jï
吱	吱	jï
諮	谘	jï
齜	龇	jï
芝	芝	jï
肢	肢	jï
輜	辎	jï
之	之	jï
唧	唧	jïd
瞻	瞻	jïm
尖	尖	jïm
詹	詹	jïm
譫	谵	jïm
霑	霑	jïm
沾	沾	jïm
占	占	jïm
煎	煎	jïn
箋	笺	jïn
羶	膻	jïn
氈	毡	jïn
招	招	jïu
椒	椒	jïu
蕉	蕉	jïu
焦	焦	jïu
礁	礁	jïu
朝	朝	jïu
唑	唑	jò
助	助	jò
坐	坐	jò
座	座	jò
鑿	凿	jòg
擢	擢	jòg
在	在	jòi
鐲	镯	jòk
軸	轴	jòk
續	续	jòk
妯	妯	jòk
族	族	jòk
躅	躅	jòk
俗	俗	jòk
逐	逐	jòk
濁	浊	jòk
鏃	镞	jòk
藏	藏	jòng
臟	脏	jòng
撞	撞	jòng
狀	状	jòng
奘	奘	jòng
頌	颂	jònk
重	重	jònk
訟	讼	jònk
誦	诵	jònk
仲	仲	jònk
燼	烬	jònt
盡	尽	jònt
造	造	jòw
皂	皂	jòw
做	做	jòw
慥	慥	jòw/côw
嶼	屿	jòy
罪	罪	jòy
序	序	jòy
墜	坠	jòy
敘	叙	jòy
聚	聚	jòy
漵	溆	jòy
綴	缀	jòy/jôy
佐	佐	jô
詛	诅	jô/jõ
作	作	jôg
昨	昨	jôg/jòg
載	载	jôi
再	再	jôi
壯	壮	jông
葬	葬	jông
戇	戆	jông/ngòng
中	中	jônk
種	种	jônk
眾	众	jônk
縱	纵	jônk
粽	粽	jônk/jõnk
縉	缙	jônt
進	进	jônt
俊	俊	jônt
竣	竣	jônt
駿	骏	jônt
峻	峻	jônt
晉	晋	jônt
灶	灶	jôw
醉	醉	jôy
惴	惴	jôy
贅	赘	jôy
最	最	jôy
左	左	jõ
俎	俎	jõ
阻	阻	jõ
宰	宰	jõi
崽	崽	jõi
載	载	jõi
駔	驵	jõng
總	总	jõnk
種	种	jõnk
腫	肿	jõnk
準	准	jõnt
儘	尽	jõnt
准	准	jõnt
隼	隼	jõnt
早	早	jõw
澡	澡	jõw
組	组	jõw
蚤	蚤	jõw
藻	藻	jõw
祖	祖	jõw
駔	驵	jõw
棗	枣	jõw
齟	龃	jõy
咀	咀	jõy
嘴	嘴	jõy
沮	沮	jõy
栽	栽	jöi
災	灾	jöi
哉	哉	jöi
竹	竹	jök
矚	瞩	jök
燭	烛	jök
捉	捉	jök
粥	粥	jök
祝	祝	jök
足	足	jök
竺	竺	jök
築	筑	jök
囑	嘱	jök
髒	脏	jöng
裝	装	jöng
贓	赃	jöng
妝	妆	jöng
樁	桩	jöng
莊	庄	jöng
中	中	jönk
終	终	jönk
縱	纵	jönk
盅	盅	jönk
宗	宗	jönk
樅	枞	jönk
鐘	钟	jönk
蹤	踪	jönk
螽	螽	jönk
棕	棕	jönk
鍾	钟	jönk
忠	忠	jönk
鬃	鬃	jönk
衷	衷	jönk/cönk
綜	综	jönk/jônk
臻	臻	jönt
津	津	jönt
樽	樽	jönt
榛	榛	jönt
諄	谆	jönt
遵	遵	jönt/jeün
怵	怵	jöt
黜	黜	jöt
卒	卒	jöt
糟	糟	jöw
租	租	jöw
遭	遭	jöw
狙	狙	jöy
追	追	jöy
錐	锥	jöy
椎	椎	jöy
蛆	蛆	jöy/cöy
秭	秭	jĩ
止	止	jĩ
只	只	jĩ
指	指	jĩ
紙	纸	jĩ
子	子	jĩ
芷	芷	jĩ
趾	趾	jĩ
酯	酯	jĩ
祉	祉	jĩ
仔	仔	jĩ
姊	姊	jĩ
咫	咫	jĩ
旨	旨	jĩ
滓	滓	jĩ
籽	籽	jĩ
址	址	jĩ
紫	紫	jĩ
梓	梓	jĩ
展	展	jĩn
輾	辗	jĩn
碾	碾	jĩn
剪	剪	jĩn
翦	翦	jĩn
闡	阐	jĩn/cĩn
沼	沼	jĩu
剿	剿	jĩu
者	者	jẽ
姐	姐	jẽ
整	整	jẽnk
井	井	jẽnk/jẽng
擒	擒	kamp
琴	琴	kamp
噙	噙	kamp
禽	禽	kamp
勤	勤	kant
芹	芹	kant
毬	毬	kaw
裘	裘	kaw
求	求	kaw
球	球	kaw
仇	仇	kaw
虯	虬	kaw
逑	逑	kaw
犰	犰	kaw
瘸	瘸	ke
騎	骑	ke
鯨	鲸	kenk
黥	黥	kenk
瓊	琼	kenk
擎	擎	kenk
強	强	keong
權	权	keun
蜷	蜷	keun
顴	颧	keun
拳	拳	keun
鬈	鬈	keun
俟	俟	key
鰭	鳍	key
耆	耆	key
旗	旗	key
奇	奇	key
岐	岐	key
期	期	key
祺	祺	key
祁	祁	key
棋	棋	key
蘄	蕲	key
琪	琪	key
旂	旂	key
琦	琦	key
歧	歧	key
淇	淇	key
祈	祈	key
其	其	key
萁	萁	key
麒	麒	key
噱	噱	keòg
強	强	keóng
羥	羟	keóng
卻	却	keôg
撅	撅	keûd
厥	厥	keûd
孓	孓	keûd
蕨	蕨	keûd
蹶	蹶	keûd
闕	阙	keûd
訣	诀	keûd
決	决	keûd
獗	獗	keûd
缺	缺	keûd
抉	抉	keûd
橛	橛	keûd/geùd
鉗	钳	kim
黔	黔	kim
犍	犍	kin
乾	乾	kin
虔	虔	kin
掮	掮	kin
蕎	荞	kiu
橋	桥	kiu
僑	侨	kiu
喬	乔	kiu
翹	翘	kiu
邛	邛	konk
穹	穹	konk
窮	穷	konk
衢	衢	koy
蠼	蠼	koy
瞿	瞿	koy
朐	朐	koy
渠	渠	koy
璩	璩	koy
群	群	kuant
裙	裙	kuant
暌	暌	kuay
睽	睽	kuay
攜	携	kuay
畦	畦	kuay
夔	夔	kuay
葵	葵	kuay
喹	喹	kuay
馗	馗	kuay
揆	揆	kuay/kuáy
狂	狂	kuong
愧	愧	kuáy
跨	跨	kuâ
挎	挎	kuâ
胯	胯	kuâ
逛	逛	kuâng
窘	窘	kuânt
困	困	kuânt
睏	困	kuânt
侉	侉	kuã
菌	菌	kuãnt
捆	捆	kuãnt
垮	垮	kuä
夸	夸	kuä
誇	夸	kuä
框	框	kuäng/höng
髡	髡	kuänt
坤	坤	kuänt
昆	昆	kuänt
崑	昆	kuänt
焜	焜	kuänt/wànt
規	规	kuäy
窺	窥	kuäy
盔	盔	kuäy
巋	岿	kuäy
虧	亏	kuäy
擴	扩	kuôg
曠	旷	kuông
礦	矿	kuông/kông
鄺	邝	kuông/kông
及	及	kàp
芨	芨	kàp/gäp
妗	妗	kámp
近	近	kánt
舅	舅	káw/kâw
臼	臼	káw/kâw
髂	髂	kâ
揢	揢	kâg
咯	咯	kâg
靠	靠	kâu
銬	铐	kâu
蔻	蔻	kâw
扣	扣	kâw
寇	寇	kâw
叩	叩	kâw
釦	扣	kâw
媾	媾	kâw/gâw
構	构	kâw/gâw
購	购	kâw/gâw
契	契	kây
卡	卡	kã
楷	楷	kãi
蒈	蒈	kãi
鍇	锴	kãi/gäi
啟	启	kãy
喀	喀	kä
卡	卡	kä
襟	襟	kämp
給	给	käp
級	级	käp
歙	歙	käp
吸	吸	käp
岌	岌	käp
汲	汲	käp
笈	笈	käp
卡	卡	kät
咳	咳	kät
摳	抠	käw
篝	篝	käw/gäw
溝	沟	käw/gäw
稽	稽	käy
溪	溪	käy
蹊	蹊	käy
嵇	嵇	käy/hay
劇	剧	kèg
屐	屐	kèg
企	企	kéy
暨	暨	kêy
驥	骥	kêy
冀	冀	kêy
傾	倾	kënk
蹊	蹊	këy
崎	崎	këy
蹺	跷	kíu
詰	诘	kîd
鍥	锲	kîd
黠	黠	kîd
孑	孑	kîd
揭	揭	kîd
頡	颉	kîd
羯	羯	kîd
竭	竭	kîd
擷	撷	kîd/gîd
翹	翘	kîu/hîu
蹺	跷	kïu/hïu
拒	拒	kóy
距	距	kóy
郝	郝	kôg
涸	涸	kôg
恪	恪	kôg
壑	壑	kôg
榷	榷	kôg
慤	悫	kôg
確	确	kôg
欬	欬	kôi
鈣	钙	kôi
慨	慨	kôi
蓋	盖	kôi
概	概	kôi
愾	忾	kôi
溉	溉	kôi
丐	丐	kôi
伉	伉	kông
抗	抗	kông
閌	闶	kông
炕	炕	kông
擴	扩	kông
亢	亢	kông
麴	曲	kök
曲	曲	kök
扛	扛	köng
拘	拘	köy
駒	驹	köy
祛	祛	köy
俱	俱	köy
區	区	köy
嶇	岖	köy
軀	躯	köy
驅	驱	köy
聒	聒	kûd
括	括	kûd
蛞	蛞	kûd
豁	豁	kûd
箍	箍	kü
聵	聩	kũi
檜	桧	kũi
澮	浍	kũi
鄶	郐	kũi
繪	绘	kũi
儈	侩	kũi
獪	狯	kũi
潰	溃	kũi
賄	贿	kũi
劊	刽	kũi
鱠	鲙	kũi
膾	脍	kũi
會	会	kũi/wùi
茄	茄	kẽ
頃	顷	kẽnk
襤	褴	lam
籃	篮	lam
婪	婪	lam
藍	蓝	lam
嵐	岚	lam
臨	临	lamp
霖	霖	lamp
琳	琳	lamp
淋	淋	lamp
林	林	lamp
啉	啉	lamp
斕	斓	lan
欄	栏	lan
攔	拦	lan
闌	阑	lan
瀾	澜	lan
襴	襕	lan
蘭	兰	lan
騮	骝	law
留	留	law
螻	螻	law
樓	楼	law
劉	刘	law
瀏	浏	law
榴	榴	law
婁	娄	law
流	流	law
琉	琉	law
硫	硫	law
撈	捞	law
髏	髅	law
僂	偻	law
瘤	瘤	law
黎	黎	lay
犁	犁	lay
犂	犂	lay
藜	藜	lay
蠡	蠡	lay/láy
羚	羚	lenk
鈴	铃	lenk
菱	菱	lenk
靈	灵	lenk
翎	翎	lenk
稜	棱	lenk
鯪	鲮	lenk
玲	玲	lenk
囹	囹	lenk
凌	凌	lenk
齡	龄	lenk
聆	聆	lenk
陵	陵	lenk
令	令	lenk
伶	伶	lenk
蛉	蛉	lenk
綾	绫	lenk
呤	呤	lenk
苓	苓	lenk
櫺	櫺	lenk
零	零	lenk
涼	凉	leong
量	量	leong
糧	粮	leong
粱	粱	leong
莨	莨	leong
良	良	leong
梁	梁	leong
巒	峦	leun
攣	挛	leun
孿	孪	leun
聯	联	leun
欒	栾	leun
灤	滦	leun
鸞	鸾	leun
罹	罹	ley
狸	狸	ley
璃	璃	ley
蜊	蜊	ley
漓	漓	ley
鱺	鲡	ley
梨	梨	ley
釐	厘	ley
籬	篱	ley
縭	缡	ley
離	离	ley
略	略	leòg
掠	掠	leòg
輛	辆	leòng
亮	亮	leòng
諒	谅	leòng
量	量	leòng
踉	踉	leòng
魎	魉	leóng
倆	俩	leóng
兩	两	leóng
兩	两	leõng
亂	乱	leùn
捋	捋	leûd
劣	劣	leûd/leùd
戀	恋	leũn
臠	脔	leũn/leun
鐮	镰	lim
廉	廉	lim
簾	帘	lim
帘	帘	lim
鏈	链	lin
憐	怜	lin
漣	涟	lin
蓮	莲	lin
連	连	lin
繚	缭	liu
嘹	嘹	liu
寥	寥	liu
獠	獠	liu
聊	聊	liu
遼	辽	liu
僚	僚	liu
寮	寮	liu
鐐	镣	liu
燎	燎	liu
撩	撩	liu
療	疗	liu
瞭	瞭	liu
鑼	锣	lo
籮	箩	lo
羅	罗	lo
邏	逻	lo
玀	猡	lo
蘿	萝	lo
螺	螺	lo/lõ
徠	徕	loi
來	来	loi
淶	涞	loi
崍	崃	loi
萊	莱	loi
莨	莨	long
狼	狼	long
螂	螂	long
鋃	锒	long
瑯	琅	long
郎	郎	long
廊	廊	long
榔	榔	long
朧	胧	lonk
蘢	茏	lonk
聾	聋	lonk
嚨	咙	lonk
窿	窿	lonk
曨	昽	lonk
瓏	珑	lonk
籠	笼	lonk
龍	龙	lonk
隆	隆	lonk
矓	眬	lonk
圇	囵	lont
鄰	邻	lont
綸	纶	lont
論	论	lont
磷	磷	lont
遴	遴	lont
麟	麟	lont
粼	粼	lont
嶙	嶙	lont
輪	轮	lont
倫	伦	lont
崙	仑	lont
掄	抡	lont
璘	璘	lont
淪	沦	lont
侖	仑	lont
鱗	鳞	lont
臚	胪	low
癆	痨	low
顱	颅	low
盧	卢	low
爐	炉	low
廬	庐	low
勞	劳	low
牢	牢	low
醪	醪	low
蘆	芦	low
轤	轳	low
瀘	泸	low
鱸	鲈	low
嘮	唠	low
羸	羸	loy
鐳	镭	loy
驢	驴	loy
閭	闾	loy
擂	擂	loy
纍	累	loy
櫚	榈	loy
雷	雷	loy
縲	缧	loy
嫘	嫘	loy
騾	骡	loy/lo
立	立	làb
蠟	蜡	làb
垃	垃	làb
砬	砬	làb
臘	腊	làb
邋	邋	làb/làd
辣	辣	làd
拉	拉	làd
賴	赖	lài
籟	籁	lài
落	落	lài
肋	肋	làk/làg
鰳	鳓	làk/làg
勒	勒	làk/làg
艦	舰	làm
纜	缆	làm
濫	滥	làm
爛	烂	làn
遛	遛	làw
漏	漏	làw
蹓	蹓	làw
鏤	镂	làw
餾	馏	làw
溜	溜	làw
陋	陋	làw
勵	励	lày
麗	丽	lày
儷	俪	lày
荔	荔	lày
礪	砺	lày
蠣	蛎	lày
厲	厉	lày
例	例	lày
欖	榄	lám
覽	览	lám
攬	揽	lám
懍	懔	lámp
凜	凛	lámp
懶	懒	lán
冷	冷	láng
柳	柳	láw
簍	篓	láw
醴	醴	láy
禮	礼	láy
鱧	鳢	láy
澧	澧	láy
喇	喇	lâ
癩	癞	lâi
摟	搂	lãw
拉	拉	lä
喇	喇	lä
啦	啦	lä
拉	拉	läi
笠	笠	läp
甩	甩	lät
嘍	喽	läw
歷	历	lèk
曆	历	lèk
力	力	lèk
令	令	lènk
愣	愣	lènk
另	另	lènk
痢	痢	lèy
蒞	莅	lèy
吏	吏	lèy
莉	莉	lèy
俐	俐	lèy
利	利	lèy
猁	猁	lèy
嶺	岭	lénk/léng
領	领	lénk/léng
理	理	léy
邐	逦	léy
鯉	鲤	léy
娌	娌	léy
李	李	léy
履	履	léy
俚	俚	léy
里	里	léy
鋰	锂	léy
哩	哩	léy/yënk/léy
靚	靓	lêng
哩	哩	lë
咧	咧	lë
礫	砾	lëk
櫪	枥	lëk
靂	雳	lëk
瀝	沥	lëk/lèk
喱	喱	lëy
璃	璃	lëy
鬣	鬣	lìb
獵	猎	lìb
捩	捩	lìd
冽	冽	lìd
列	列	lìd
裂	裂	lìd
烈	烈	lìd
襝	裣	lìm
斂	敛	lìm
練	练	lìn
煉	炼	lìn
廖	廖	lìu
尥	尥	lìu
料	料	lìu
殮	殓	lím
臉	脸	lím
輦	辇	lín
攆	撵	lín
了	了	líu
瞭	了	líu
潦	潦	líu/lĩu
哩	哩	lï
令	令	lïm
撂	撂	lïu
溜	溜	lïu
撩	撩	lïu
樂	乐	lòg
落	落	lòg
賚	赉	lòi
睞	睐	lòi
耒	耒	lòi/lòy
戮	戮	lòk
鹿	鹿	lòk
陸	陆	lòk
祿	禄	lòk
漉	漉	lòk
氯	氯	lòk
六	六	lòk
錄	录	lòk
綠	绿	lòk
碌	碌	lòk
浪	浪	lòng
蒗	蒗	lòng
晾	晾	lòng
閬	阆	lòng/long
弄	弄	lònk
藺	蔺	lònt
吝	吝	lònt
躪	躏	lònt
論	论	lònt
律	律	lòt
栗	栗	lòt
篥	篥	lòt
慄	栗	lòt
率	率	lòt
鷸	鹬	lòt
溧	溧	lòt
傈	傈	lòt
路	路	lòw
賂	赂	lòw
輅	辂	lòw
潞	潞	lòw
嫪	嫪	lòw
露	露	lòw
璐	璐	lòw
澇	涝	lòw
勞	劳	lòw
鷺	鹭	lòw
淚	泪	lòy
濾	滤	lòy
戾	戾	lòy
漯	漯	lòy
慮	虑	lòy
類	类	lòy
累	累	lòy
朗	朗	lóng
攏	拢	lónk
壟	垄	lónk
籠	笼	lónk
隴	陇	lónk
虜	虏	lów
老	老	lów
姥	姥	lów
擄	掳	lów
魯	鲁	lów
滷	卤	lów
鹵	卤	lów
櫓	橹	lów
累	累	lóy
屢	屡	lóy
裡	里	lóy
壘	垒	lóy
褸	褛	lóy
鋁	铝	lóy
縷	缕	lóy
儡	儡	lóy
磊	磊	lóy
膂	膂	lóy
侶	侣	lóy
呂	吕	lóy
旅	旅	lóy
蕾	蕾	lóy/loy
絡	络	lôg
珞	珞	lôg
鉻	铬	lôg
酪	酪	lôg
餎	饹	lôg
烙	烙	lôg
駱	骆	lôg/lòg
洛	洛	lôg/lòg
裸	裸	lõ
郎	郎	lõng
卵	卵	lõnt
佬	佬	lõw
囉	囉	lö
咯	咯	lö
旯	旯	lö/lôg
麓	麓	lök
碌	碌	lök
轆	辘	lök
啷	啷	löng
撈	捞	löw
嚕	噜	löw
咧	咧	lẽ
痲	麻	ma
蟆	蟆	ma
麻	麻	ma
埋	埋	mai
霾	霾	mai/may
饅	馒	man
蠻	蛮	man
鰻	鳗	man
謾	谩	man
蔓	蔓	man
盲	盲	mang
盟	盟	mank
萌	萌	mank
岷	岷	mant
珉	珉	mant
氓	氓	mant
旻	旻	mant
苠	苠	mant
緡	缗	mant
雯	雯	mant
紋	纹	mant
玟	玟	mant
文	文	mant
民	民	mant
忞	忞	mant
聞	闻	mant
茅	茅	mau
矛	矛	mau
謀	谋	maw
牟	牟	maw
眸	眸	maw
繆	缪	maw
迷	迷	may
瞇	眯	may
醚	醚	may
謎	谜	may
溟	溟	menk
洺	洺	menk
螟	螟	menk
名	名	menk
鳴	鸣	menk
冥	冥	menk
明	明	menk
暝	暝	menk/mènk
瞑	瞑	menk/ménk
銘	铭	menk/ménk
靡	靡	mey
薇	薇	mey
蘼	蘼	mey
麋	麋	mey
楣	楣	mey
湄	湄	mey
微	微	mey
眉	眉	mey
嵋	嵋	mey
瀰	弥	mey/ney
獼	猕	mey/ney
綿	绵	min
棉	棉	min
眠	眠	min
瞄	瞄	miu
苗	苗	miu
描	描	miu
磨	磨	mo
蘑	蘑	mo
饃	馍	mo
莽	莽	mong
茫	茫	mong
虻	虻	mong
忘	忘	mong
芒	芒	mong
忙	忙	mong
亡	亡	mong
鋩	铓	mong
氓	氓	mong
檬	檬	monk
濛	蒙	monk
蒙	蒙	monk
矇	蒙	monk
曚	曚	monk
朦	朦	monk
無	无	mow
蕪	芜	mow
毛	毛	mow
誣	诬	mow
膜	膜	mow
毋	毋	mow
巫	巫	mow
謨	谟	mow
模	模	mow
髦	髦	mow
摹	摹	mow
氂	牦	mow/ley
霉	霉	mui
梅	梅	mui
枚	枚	mui
玫	玫	mui
煤	煤	mui
媒	媒	mui
酶	酶	mui
莓	莓	mui
門	门	mun
瞞	瞒	mun
捫	扪	mun
們	们	mun
鞔	鞔	mun
罵	骂	mà
賣	卖	mài
邁	迈	mài
陌	陌	màk
貘	貘	màk
驀	蓦	màk
默	默	màk
万	万	màk
墨	墨	màk
脈	脉	màk
麥	麦	màk
謾	谩	màn
慢	慢	màn
漫	漫	màn
縵	缦	màn
熳	熳	màn
蔓	蔓	màn
鏝	镘	màn
嫚	嫚	màn
曼	曼	màn
萬	万	màn
幔	幔	màn
墁	墁	màn
孟	孟	màng
汶	汶	mànt
問	问	mànt
紊	紊	mànt
蜜	蜜	màt
勿	勿	màt
密	密	màt
物	物	màt
襪	袜	màt
謐	谧	màt
宓	宓	màt
嘧	嘧	màt
懋	懋	màu
貌	貌	màu
袤	袤	màu
茂	茂	màw
貿	贸	màw
謬	谬	màw
袂	袂	mày
瑪	玛	má
碼	码	má
螞	蚂	má
獁	犸	má
馬	马	má
蕒	荬	mái
買	买	mái
晚	晚	mán
猛	猛	máng
錳	锰	máng
蜢	蜢	máng
勐	勐	máng
閩	闽	mánt
閔	闵	mánt
吻	吻	mánt
刎	刎	mánt
憫	悯	mánt
鰵	鳘	mánt
黽	黾	mánt
湣	湣	mánt
愍	愍	mánt
抿	抿	mánt
泯	泯	mánt
敏	敏	mánt
澠	渑	mánt
鉚	铆	máu
卯	卯	máu
某	某	máw
牡	牡	máw
畝	亩	máw
米	米	máy
嘛	嘛	mâ
擘	擘	mâg
嬤	嬷	mä
媽	妈	mä
嗎	吗	mä/mâ
繃	绷	mäng
蚊	蚊	mänt
貓	猫	mäu
哞	哞	mäw
咪	咪	mäy/mëy
汨	汨	mèk
鼏	鼏	mèk
覓	觅	mèk
冪	幂	mèk
命	命	mèng
命	命	mènk
未	未	mèy
味	味	mèy
寐	寐	mèy
魅	魅	mèy
媚	媚	mèy
皿	皿	ménk
酩	酩	ménk
茗	茗	ménk/menk
鎂	镁	méy
美	美	méy
娓	娓	méy
尾	尾	méy
媺	媺	méy
哶	哶	më
蔑	蔑	mìd
篾	篾	mìd
衊	蔑	mìd
滅	灭	mìd
麵	面	mìn
面	面	mìn
廟	庙	mìu
妙	妙	mìu
冕	冕	mín
娩	娩	mín
靦	腼	mín
勉	勉	mín
緬	缅	mín
免	免	mín
邈	邈	míu
藐	藐	míu
淼	淼	míu
杳	杳	míu
緲	缈	míu
秒	秒	míu
渺	渺	míu
喵	喵	mïu
莫	莫	mòg
幕	幕	mòg
膜	膜	mòg
漠	漠	mòg
寞	寞	mòg
木	木	mòk
沐	沐	mòk
穆	穆	mòk
睦	睦	mòk
鉬	钼	mòk
苜	苜	mòk
仫	仫	mòk
目	目	mòk
牧	牧	mòk
望	望	mòng
夢	梦	mònk
耄	耄	mòw
慕	慕	mòw
帽	帽	mòw
霧	雾	mòw
瑁	瑁	mòw
暮	暮	mòw
冒	冒	mòw
騖	骛	mòw
婺	婺	mòw
募	募	mòw
戊	戊	mòw
務	务	mòw
墓	墓	mòw
鶩	鹜	mòw
惘	惘	móng
妄	妄	móng
輞	辋	móng
魍	魍	móng
罔	罔	móng
蟒	蟒	móng
網	网	móng
蠓	蠓	mónk
懵	懵	mónk/mõnk
拇	拇	mów
姆	姆	mów
侮	侮	mów
武	武	mów
舞	舞	mów
嫵	妩	mów
鵡	鹉	mów
母	母	mów
摸	摸	mõ
魔	魔	mö
摩	摩	mö
麼	么	mö
剝	剥	mög
沒	没	mùd
歿	殁	mùd
末	末	mùd
靺	靺	mùd
茉	茉	mùd
妹	妹	mùi
昧	昧	mùi
燜	焖	mùn
悶	闷	mùn
每	每	múi
蟎	螨	mún
滿	满	mún
沫	沫	mûd
抹	抹	mûd/mâd
拿	拿	na
南	南	na
哪	哪	na
娜	娜	na
男	男	nam
楠	楠	nam
南	南	nam
喃	喃	nam
囡	囡	nam
難	难	nan
能	能	nank
橈	桡	nau
猱	猱	nau
撓	挠	nau
錨	锚	nau
鐃	铙	nau
泥	泥	nay
呢	呢	nay/ney
獰	狞	nenk
檸	柠	nenk
寧	宁	nenk
嚀	咛	nenk
娘	娘	neong
怩	怩	ney
妮	妮	ney
尼	尼	ney
彌	弥	ney
鈮	铌	ney
嫩	嫩	neùn
暖	暖	neún
鼯	鼯	ng
蜈	蜈	ng
吾	吾	ng
梧	梧	ng
吳	吴	ng
牙	牙	nga
芽	芽	nga
衙	衙	nga
涯	涯	ngai
厓	厓	ngai
睚	睚	ngai
崖	崖	ngai
捱	挨	ngai
癌	癌	ngam
岩	岩	ngam
顏	颜	ngan
齗	龂	ngant
齦	龈	ngant
垠	垠	ngant
沂	沂	ngant
銀	银	ngant
淆	淆	ngau
爻	爻	ngau
餚	肴	ngau
牛	牛	ngaw
猊	猊	ngay
霓	霓	ngay
危	危	ngay
倪	倪	ngay
巍	巍	ngay
鵝	鹅	ngo
哦	哦	ngo
訛	讹	ngo
俄	俄	ngo
峨	峨	ngo
娥	娥	ngo
莪	莪	ngo
蛾	蛾	ngo
呆	呆	ngoi
昂	昂	ngong
鰲	鳌	ngow
獒	獒	ngow
驁	骜	ngow
敖	敖	ngow
螯	螯	ngow
翱	翱	ngow
熬	熬	ngow/ngaw
遨	遨	ngow/ngòw
訝	讶	ngà
額	额	ngàg
砹	砹	ngài
艾	艾	ngài
刈	刈	ngài
贗	赝	ngàn
雁	雁	ngàn
硬	硬	ngàng
杌	杌	ngàt
兀	兀	ngàt
圪	圪	ngàt
迄	迄	ngàt
屹	屹	ngàt
藝	艺	ngày
囈	呓	ngày
毅	毅	ngày
睨	睨	ngày
偽	伪	ngày
羿	羿	ngày
魏	魏	ngày
詣	诣	ngày
佤	佤	ngá
雅	雅	ngá
瓦	瓦	ngá
眼	眼	ngán
咬	咬	ngáu
偶	偶	ngáw
藕	藕	ngáw
蟻	蚁	ngáy
勾	勾	ngäw
齧	啮	ngìd/ngàd
臥	卧	ngò
餓	饿	ngò
愕	愕	ngòg
嶽	岳	ngòg
岳	岳	ngòg
鄂	鄂	ngòg
鱷	鳄	ngòg
噩	噩	ngòg
顎	颚	ngòg
樂	乐	ngòg
外	外	ngòi
礙	碍	ngòi
岸	岸	ngòn
犴	犴	ngòn
傲	傲	ngòw
我	我	ngó
盎	盎	ngông/ngõng
懊	懊	ngôw
澳	澳	ngôw
奧	奥	ngôw
襖	袄	ngôw/ngõw
骯	肮	ngöng/ngông
鯰	鲇	nim
年	年	nin
挪	挪	no
挼	挼	no
饢	馕	nong
瓤	瓤	nong
囔	囔	nong
囊	囊	nong
農	农	nonk
儂	侬	nonk
濃	浓	nonk
膿	脓	nonk
奴	奴	now
吶	呐	nàb
納	纳	nàb
衲	衲	nàb
鈉	钠	nàb
捺	捺	nàd
難	难	nàn
鬧	闹	nàu
淖	淖	nàu
哪	哪	ná
那	那	ná
乃	乃	nái
氖	氖	nái
奶	奶	nái
鼐	鼐	nái
腩	腩	nám
稔	稔	námp
赧	赧	nán
紐	纽	nãw
妞	妞	nãw
狃	狃	nãw
朽	朽	nãw
鈕	钮	nãw
扭	扭	nãw
哪	哪	nä
粒	粒	näp/läp
孬	孬	näu
佞	佞	nènk
擰	拧	nènk
濘	泞	nènk
膩	腻	nèy
餌	饵	nèy
你	你	néy
妳	你	néy
旎	旎	néy
您	您	néy
呢	呢	në
匿	匿	nëk
暱	昵	nëk
溺	溺	nëk/nèk
捏	捏	nìb
聶	聂	nìb
顳	颞	nìb
鑷	镊	nìb
涅	涅	nìb
隉	陧	nìb
躡	蹑	nìb
念	念	nìm
唸	念	nìm
廿	廿	nìm
尿	尿	nìu
溺	溺	nìu
碾	碾	nín
鳥	鸟	níu
裊	袅	níu
鎳	镍	nïb
拈	拈	nïm
粘	粘	nïm/jïm
黏	黏	nïm/jïm
糯	糯	nò
懦	懦	nò
諾	诺	nòg
內	内	nòi
奈	奈	nòi
耐	耐	nòi
忸	忸	nòk/nãw
齉	齉	nòng
訥	讷	nòt/nàb
怒	怒	nòw
饢	馕	nóng
腦	脑	nów
惱	恼	nów
瑙	瑙	nów
弩	弩	nów
努	努	nów/lów
釹	钕	nóy
餒	馁	nóy
女	女	nóy/lóy
捻	捻	nĩm
哦	哦	o
琶	琶	pa
爬	爬	pa
耙	耙	pa
杷	杷	pa
扒	扒	pa
俳	俳	pai
排	排	pai
牌	牌	pai
硼	硼	pang
澎	澎	pang
棚	棚	pang
鵬	鹏	pang
膨	膨	pang
彭	彭	pang
朋	朋	pank
憑	凭	pank
貧	贫	pant
嬪	嫔	pant
頻	频	pant
顰	颦	pant
匏	匏	pau
咆	咆	pau
麅	狍	pau
刨	刨	pau
庖	庖	pau
抔	抔	paw
評	评	penk
萍	萍	penk
平	平	penk
屏	屏	penk
坪	坪	penk
蘋	苹	penk
瓶	瓶	penk
郫	郫	pey
枇	枇	pey
蜱	蜱	pey
脾	脾	pey
貔	貔	pey
琵	琵	pey
毗	毗	pey
皮	皮	pey
邳	邳	pey
疲	疲	pey
駢	骈	pin
便	便	pin
瓢	瓢	piu
嫖	嫖	piu
朴	朴	piu
婆	婆	po
鄱	鄱	po/bô
膀	膀	pong
彷	彷	pong
龐	庞	pong
螃	螃	pong
滂	滂	pong
磅	磅	pong
旁	旁	pong
篷	篷	ponk
芃	芃	ponk
蓬	蓬	ponk/fonk
莆	莆	pow
蒲	蒲	pow
葡	葡	pow
脯	脯	pow
匍	匍	pow
袍	袍	pow
菩	菩	pow
徘	徘	pui
陪	陪	pui
裴	裴	pui
培	培	pui
賠	赔	pui
蟠	蟠	pun
盤	盘	pun
磐	磐	pun
槃	槃	pun
盆	盆	pun
蹣	蹒	pun/mun
棒	棒	páng
牝	牝	pánt
睥	睥	páy
怕	怕	pâ
柏	柏	pâg
拍	拍	pâg
珀	珀	pâg
帕	帕	pâg
魄	魄	pâg
哌	哌	pâi
派	派	pâi
湃	湃	pâi/bâi
盼	盼	pân
袢	袢	pân
噴	喷	pânt
炮	炮	pâu
豹	豹	pâu
泡	泡	pâu
疱	疱	pâu
跑	跑	pãu
剖	剖	pãw
趴	趴	pä
啪	啪	päg
攀	攀	pän
扳	扳	pän
烹	烹	päng
澎	澎	päng
匹	匹	pät
疋	疋	pät
泡	泡	päu
拋	抛	päu
脬	脬	päu
批	批	päy
被	被	péy
婢	婢	péy
劈	劈	pêg
聘	聘	pênk
譬	譬	pêy
屁	屁	pêy
濞	濞	pêy
媲	媲	pêy/bẽy
癖	癖	pëk
辟	辟	pëk
僻	僻	pëk
霹	霹	pëk
闢	辟	pëk
抨	抨	pënk
砰	砰	pënk
怦	怦	pënk
姘	姘	pënk
娉	娉	pënk
拼	拼	pënk/pênk
紕	纰	pëy
呸	呸	pëy
狉	狉	pëy
披	披	pëy
丕	丕	pëy
鰾	鳔	píu
瞟	瞟	píu
瞥	瞥	pîd
撇	撇	pîd
騙	骗	pîn
片	片	pîn
遍	遍	pîn
漂	漂	pîu
票	票	pîu
剽	剽	pîu/píu
編	编	pïn
偏	偏	pïn
翩	翩	pïn
扁	扁	pïn
篇	篇	pïn
蝙	蝙	pïn/bïn
漂	漂	pïu
飄	飘	pïu
嘌	嘌	pïu
縹	缥	pïu
蚌	蚌	póng
抱	抱	pów
泡	泡	pów
破	破	pô
撲	扑	pôg
噗	噗	pôg
樸	朴	pôg
釙	钋	pôg
璞	璞	pôg
粕	粕	pôg/pâg
謗	谤	pông
碰	碰	pônk
舖	铺	pôw
叵	叵	põ
頗	颇	põ
笸	笸	põ
捧	捧	põnk/bõnk
浦	浦	põw
譜	谱	põw
普	普	põw
溥	溥	põw
脯	脯	põw/fũ
頗	颇	pö
坡	坡	pö/bö
棵	棵	pö/fõ
仆	仆	pök
鋪	铺	pöw
倍	倍	púi
蓓	蓓	púi/pui
潑	泼	pûd
霈	霈	pûi
佩	佩	pûi
珮	珮	pûi
沛	沛	pûi
配	配	pûi
拚	拚	pûn
判	判	pûn
胚	胚	püi
坯	坯	püi
番	番	pün
潘	潘	pün
片	片	pĩn
片	片	pĩn
仳	仳	pẽy
痞	痞	pẽy
吡	吡	pẽy
否	否	pẽy
圮	圮	pẽy
鄙	鄙	pẽy
忱	忱	samp
涔	涔	samp
岑	岑	samp
梣	梣	samp
潺	潺	san
孱	孱	san
晨	晨	sant
臣	臣	sant
辰	辰	sant
神	神	sant
仇	仇	saw
愁	愁	saw
蛇	蛇	se
畲	畲	se
城	城	senk
成	成	senk
乘	乘	senk
盛	盛	senk
丞	丞	senk
誠	诚	senk
繩	绳	senk
澠	渑	senk
承	承	senk
償	偿	seong
裳	裳	seong
徜	徜	seong
嘗	尝	seong
嚐	尝	seong
常	常	seong
嫦	嫦	seong
殊	殊	seu
薯	薯	seu
漩	漩	seun
璇	璇	seun
旋	旋	seun
船	船	seun
上	上	seòng
尚	尚	seòng
上	上	seóng
爍	烁	seôg
鑠	铄	seôg
削	削	seôg
相	相	seông
鯗	鲞	seõng
想	想	seõng
賞	赏	seõng
傷	伤	seöng
廂	厢	seöng
霜	霜	seöng
雙	双	seöng
商	商	seöng
孀	孀	seöng
鸘	鹴	seöng
相	相	seöng
襄	襄	seöng
箱	箱	seöng
湘	湘	seöng
觴	觞	seöng
殤	殇	seöng
鑲	镶	seöng
豎	竖	seù
樹	树	seù
篆	篆	seùn
雋	隽	seún
吮	吮	seún
戍	戍	seû
恕	恕	seû
庶	庶	seû
雪	雪	seûd
鱈	鳕	seûd
說	说	seûd
算	算	seûn
蒜	蒜	seûn
渲	渲	seûn/heün
舒	舒	seü
抒	抒	seü
書	书	seü
輸	输	seü
紓	纾	seü
樞	枢	seü
悛	悛	seün
瑄	瑄	seün
飧	飧	seün
狻	狻	seün
蓀	荪	seün
宣	宣	seün
酸	酸	seün
猻	狲	seün
孫	孙	seün
黍	黍	seũ
暑	暑	seũ
鼠	鼠	seũ
損	损	seũn
選	选	seũn
蒔	莳	si
匙	匙	si
鰣	鲥	si
時	时	si
蟾	蟾	sim
禪	禅	sim
單	单	sim
蟬	蝉	sin
傻	傻	so
崇	崇	sonk
淳	淳	sont
脣	唇	sont
醇	醇	sont
純	纯	sont
鶉	鹑	sont/cönt
誰	谁	soy
垂	垂	soy
什	什	sàmp
甚	甚	sàmp
椹	葚	sàmp
慎	慎	sànt
蜃	蜃	sànt/sánt
拾	拾	sàp
十	十	sàp
實	实	sàt
壽	寿	sàw
授	授	sàw
受	受	sàw
售	售	sàw
綬	绶	sàw
噬	噬	sày
誓	誓	sày
筮	筮	sày
逝	逝	sày
腎	肾	sánt
舐	舐	sáy/sãy
圾	圾	sâb
颯	飒	sâb
薩	萨	sâd
鎩	铩	sâd
煞	煞	sâd
殺	杀	sâd
撒	撒	sâd
剎	刹	sâd
索	索	sâg/sôg
曬	晒	sâi
三	三	sâm
沁	沁	sâmp
滲	渗	sâmp
訕	讪	sân
汕	汕	sân
涮	涮	sân
傘	伞	sân
散	散	sân
疝	疝	sân
篡	篡	sân
蹭	蹭	sânk
擤	擤	sânk
霎	霎	sâp
哨	哨	sâu
狩	狩	sâw
嗽	嗽	sâw
獸	兽	sâw
鏽	锈	sâw
繡	绣	sâw
漱	漱	sâw
琇	琇	sâw
秀	秀	sâw
瘦	瘦	sâw
宿	宿	sâw
世	世	sây
細	细	sây
勢	势	sây
婿	婿	sây
耍	耍	sã
灑	洒	sã
璽	玺	sãi
徙	徙	sãi
嬸	婶	sãmp
審	审	sãmp
瀋	沈	sãmp
沈	沈	sãmp
散	散	sãn
省	省	sãng
稍	稍	sãu
首	首	sãw
搜	搜	sãw
守	守	sãw
手	手	sãw
嗾	嗾	sãw
擻	擞	sãw
艘	艘	sãw/säw
駛	驶	sãy
使	使	sãy
洗	洗	sãy
莎	莎	sä
紗	纱	sä
鯊	鲨	sä
卅	卅	sä
砂	砂	sä
裟	裟	sä
啥	啥	sä
痧	痧	sä
沙	沙	sä
噻	噻	säk
塞	塞	säk
三	三	säm
仨	仨	säm
叄	叁	säm
衫	衫	säm
心	心	sämp
參	参	sämp
郴	郴	sämp
深	深	sämp
琛	琛	sämp
芯	芯	sämp
森	森	sämp
刪	删	sän
潸	潸	sän
舢	舢	sän
拴	拴	sän
姍	姗	sän
山	山	sän
閂	闩	sän
珊	珊	sän
栓	栓	sän
跚	跚	sän
甥	甥	säng
牲	牲	säng
笙	笙	sänk
生	生	sänk/säng
燊	燊	sänt
呻	呻	sänt
伸	伸	sänt
新	新	sänt
薪	薪	sänt
娠	娠	sänt
身	身	sänt
砷	砷	sänt
辛	辛	sänt
鋅	锌	sänt
莘	莘	sänt
紳	绅	sänt
申	申	sänt
濕	湿	säp
澀	涩	säp/sëk/gîb
室	室	sät
蝨	虱	sät
失	失	sät
膝	膝	sät
瑟	瑟	sät
捎	捎	säu
梢	梢	säu
收	收	säw
螋	螋	säw
嗖	嗖	säw
餿	馊	säw
颼	飕	säw
羞	羞	säw
修	修	säw
搜	搜	säw/sãw
篩	筛	säy
犀	犀	säy
嘶	嘶	säy
西	西	säy
舾	舾	säy
硒	硒	säy
射	射	sè
麝	麝	sè
碩	硕	sèg
石	石	sèg
蝕	蚀	sèk
食	食	sèk
盛	盛	sènk
剩	剩	sènk
嵊	嵊	sènk
社	社	sé
猞	猞	sê
卸	卸	sê
赦	赦	sê
瀉	泻	sê
舍	舍	sê
錫	锡	sêg
姓	姓	sênk
勝	胜	sênk
聖	圣	sênk
性	性	sênk
四	四	sêy
些	些	së
昔	昔	sëk
銫	铯	sëk
飾	饰	sëk
晰	晰	sëk
析	析	sëk
識	识	sëk
蜥	蜥	sëk
拭	拭	sëk
息	息	sëk
皙	皙	sëk
惜	惜	sëk
色	色	sëk
適	适	sëk
媳	媳	sëk
嗇	啬	sëk
軾	轼	sëk
淅	淅	sëk
式	式	sëk
蟋	蟋	sëk
悉	悉	sëk
螫	螫	sëk
熄	熄	sëk
釋	释	sëk
陞	升	sënk
惺	惺	sënk
猩	猩	sënk
星	星	sënk
升	升	sënk
昇	升	sënk
勝	胜	sënk
腥	腥	sënk/sëng
聲	声	sënk/sëng
侍	侍	sì
士	士	sì
事	事	sì
是	是	sì
伺	伺	sì
仕	仕	sì
豉	豉	sì
氏	氏	sì
視	视	sì
示	示	sì
贍	赡	sìm
膳	膳	sìn
撣	掸	sìn
嬗	嬗	sìn
擅	擅	sìn
繕	缮	sìn
倩	倩	sìn
善	善	sìn
羨	羡	sìn
禪	禅	sìn
單	单	sìn
鄯	鄯	sìn
茜	茜	sìn/säy
邵	邵	sìu
劭	劭	sìu
肇	肇	sìu
兆	兆	sìu
紹	绍	sìu
市	市	sí
鱔	鳝	sín
泗	泗	sî
使	使	sî
嗜	嗜	sî
弒	弑	sî
肆	肆	sî
諡	谥	sî
試	试	sî
駟	驷	sî
攝	摄	sîb
歙	歙	sîb
涉	涉	sîb
懾	慑	sîb/jîb
舌	舌	sîd
褻	亵	sîd
竊	窃	sîd
洩	泄	sîd
薛	薛	sîd
屑	屑	sîd
楔	楔	sîd
絏	绁	sîd
揳	揳	sîd/sîb
腺	腺	sîn
扇	扇	sîn
煽	煽	sîn
騸	骟	sîn
霰	霰	sîn
線	线	sîn
嘯	啸	sîu
笑	笑	sîu
少	少	sîu
尸	尸	sï
絲	丝	sï
師	师	sï
獅	狮	sï
詩	诗	sï
私	私	sï
撕	撕	sï
蓍	蓍	sï
斯	斯	sï
司	司	sï
施	施	sï
屍	尸	sï
廝	厮	sï
思	思	sï
仙	仙	sïn
鮮	鲜	sïn
酰	酰	sïn
先	先	sïn
氙	氙	sïn/sän
消	消	sïu
銷	销	sïu
燒	烧	sïu
霄	霄	sïu
宵	宵	sïu
蕭	萧	sïu
硝	硝	sïu
逍	逍	sïu
簫	箫	sïu
韶	韶	sïu
瀟	潇	sïu
魈	魈	sïu
孰	孰	sòk
屬	属	sòk
淑	淑	sòk
塾	塾	sòk
蜀	蜀	sòk
菽	菽	sòk
熟	熟	sòk
贖	赎	sòk
順	顺	sònt
沭	沭	sòt
述	述	sòt
術	术	sòt
萃	萃	sòy
燧	燧	sòy
邃	邃	sòy
隧	隧	sòy
瑞	瑞	sòy
穗	穗	sòy
祟	祟	sòy
粹	粹	sòy
遂	遂	sòy
悴	悴	sòy
睡	睡	sòy
瘁	瘁	sòy/sóy
緒	绪	sóy
髓	髓	sóy
墅	墅	sóy
絮	絮	sóy/sòy
索	索	sôg
說	说	sôg
朔	朔	sôg
喪	丧	sông
送	送	sônk
宋	宋	sônk
巽	巽	sônt
舜	舜	sônt
信	信	sônt
迅	迅	sônt
浚	浚	sônt
瞬	瞬	sônt
遜	逊	sônt
訊	讯	sônt
汛	汛	sônt
囟	囟	sônt/sõnt
訴	诉	sôw
數	数	sôw
溯	溯	sôw
掃	扫	sôw
塑	塑	sôw
愫	愫	sôw
臊	臊	sôw
素	素	sôw
帥	帅	sôy
歲	岁	sôy
碎	碎	sôy
稅	税	sôy
說	说	sôy
瑣	琐	sõ
鎖	锁	sõ
嗩	唢	sõ
所	所	sõ
嗓	嗓	sõng
搡	搡	sõng
爽	爽	sõng
竦	竦	sõnk
慫	怂	sõnk
聳	耸	sõnk
悚	悚	sõnk
榫	榫	sõnt
筍	笋	sõnt
數	数	sõw
嫂	嫂	sõw
水	水	sõy
梭	梭	sö
唆	唆	sö
梳	梳	sö
羧	羧	sö
嗦	嗦	sö
疏	疏	sö
蔬	蔬	sö
蓑	蓑	sö
腮	腮	söi
鰓	鳃	söi
夙	夙	sök
粟	粟	sök
宿	宿	sök
蓿	蓿	sök
鷫	鹔	sök
叔	叔	sök
肅	肃	sök
倏	倏	sök
縮	缩	sök
僳	僳	sök
桑	桑	söng
喪	丧	söng
嵩	嵩	sönk
從	从	sönk
淞	淞	sönk
鬆	松	sönk
忪	忪	sönk
荀	荀	sönt
芯	芯	sönt
詢	询	sönt
殉	殉	sönt
峋	峋	sönt
恤	恤	söt
摔	摔	söt
蟀	蟀	söt
率	率	söt
戌	戌	söt
騷	骚	söw
囌	苏	söw
蘇	苏	söw
搔	搔	söw
甦	甦	söw
酥	酥	söw
鬚	须	söw
臊	臊	söw
穌	稣	söw
雖	虽	söy
荽	荽	söy
須	须	söy
胥	胥	söy
需	需	söy
衰	衰	söy
睢	睢	söy
濉	濉	söy
綏	绥	söy
屎	屎	sĩ
使	使	sĩ
史	史	sĩ
陝	陕	sĩm
閃	闪	sĩm
跣	跣	sĩn
鮮	鲜	sĩn
冼	冼	sĩn
癬	癣	sĩn
少	少	sĩu
筱	筱	sĩu
小	小	sĩu
捨	舍	sẽ
寫	写	sẽ
省	省	sẽnk
醒	醒	sẽnk/sẽng
死	死	sẽy
覃	覃	tam
澹	澹	tam
談	谈	tam
曇	昙	tam
郯	郯	tam
譚	谭	tam
潭	潭	tam
痰	痰	tam
彈	弹	tan
檀	檀	tan
壇	坛	tan
謄	誊	tank
疼	疼	tank
騰	腾	tank
藤	藤	tank
滕	滕	tank
頭	头	taw
投	投	taw
骰	骰	taw/sëk
堤	堤	tay
緹	缇	tay
醍	醍	tay
啼	啼	tay
鵜	鹈	tay
蹄	蹄	tay
題	题	tay
提	提	tay
廷	廷	tenk
亭	亭	tenk
庭	庭	tenk
婷	婷	tenk
霆	霆	tenk
蜓	蜓	tenk
停	停	tenk
臀	臀	teun
糰	团	teun
屯	屯	teun
豚	豚	teun
團	团	teun
囤	囤	teun
斷	断	teún
脫	脱	teûd
恬	恬	tim
甜	甜	tim
闐	阗	tin
鈿	钿	tin
田	田	tin
填	填	tin
鈿	钿	tin/dìn
滇	滇	tin/dïn
迢	迢	tiu
笤	笤	tiu
齠	龆	tiu
條	条	tiu
調	调	tiu
髫	髫	tiu
舵	舵	to
馱	驮	to
佗	佗	to
鴕	鸵	to
駝	驼	to
沱	沱	to
陀	陀	to
颱	台	toi
跆	跆	toi
台	台	toi
苔	苔	toi
枱	台	toi
薹	薹	toi
抬	抬	toi
醣	醣	tong
幢	幢	tong
塘	塘	tong
膛	膛	tong
唐	唐	tong
棠	棠	tong
堂	堂	tong
溏	溏	tong
螳	螳	tong
搪	搪	tong/tóng
糖	糖	tong/tõng
衕	同	tonk
彤	彤	tonk
峒	峒	tonk
同	同	tonk
僮	僮	tonk
桐	桐	tonk
瞳	瞳	tonk
佟	佟	tonk
銅	铜	tonk
酮	酮	tonk
童	童	tonk
潼	潼	tonk
陶	陶	tow
屠	屠	tow
檮	梼	tow
啕	啕	tow
洮	洮	tow
涂	涂	tow
圖	图	tow
逃	逃	tow
塗	涂	tow
萄	萄	tow
鼗	鼗	tow
掏	掏	tow
桃	桃	tow
徒	徒	tow
淘	淘	tow
荼	荼	tow
途	途	tow
濤	涛	tow
頹	颓	toy
淡	淡	tám
榻	榻	tâb
塌	塌	tâb
塔	塔	tâb
漯	漯	tâb
遢	遢	tâb/tâd
闥	闼	tâd
撻	挞	tâd
躂	跶	tâd
韃	鞑	tâd
趿	趿	tâd
肽	肽	tâi
太	太	tâi
貸	贷	tâi
汰	汰	tâi
泰	泰	tâi
傣	傣	tâi
態	态	tâi
鈦	钛	tâi
探	探	tâm
罈	坛	tâm
炭	炭	tân
歎	叹	tân
碳	碳	tân
褪	褪	tânt
透	透	tâw
嚏	嚏	tây
替	替	tây
屜	屉	tây
涕	涕	tây
剃	剃	tây
毯	毯	tãm
袒	袒	tãn
鉭	钽	tãn
忐	忐	tãn
疸	疸	tãn
亶	亶	tãn
坦	坦	tãn
體	体	tãy
牠	它	tä
鉈	铊	tä
祂	他	tä
她	她	tä
它	它	tä
他	他	tä
貪	贪	täm
癱	瘫	tän
攤	摊	tän
坍	坍	tän
灘	滩	tän
吞	吞	tänt
飩	饨	tänt
偷	偷	täw
梯	梯	täy
銻	锑	täy
挺	挺	ténk
鋌	铤	ténk
艇	艇	ténk/téng
踢	踢	têg
聽	听	tênk
忑	忑	tëk
倜	倜	tëk
剔	剔	tëk
惕	惕	tëk
忒	忒	tëk
鋱	铽	tëk
汀	汀	tënk
烴	烃	tënk
廳	厅	tënk/tëng
聽	听	tënk/tëng
殄	殄	tín/tím
窕	窕	tíu
挑	挑	tíu
萜	萜	tîb
貼	贴	tîb
帖	帖	tîb
餮	餮	tîd
鐵	铁	tîd
跳	跳	tîu
眺	眺	tîu
添	添	tïm
天	天	tïn
挑	挑	tïu
盾	盾	tónt
肚	肚	tów
唾	唾	tô/teô
橐	橐	tôg
拓	拓	tôg
庹	庹	tôg
托	托	tôg
託	托	tôg
蹚	蹚	tông
熨	熨	tông
趟	趟	tông
燙	烫	tông
痛	痛	tônk
彖	彖	tônt
套	套	tôw
兔	兔	tôw
吐	吐	tôw
退	退	tôy
蛻	蜕	tôy
橢	椭	tõ
妥	妥	tõ
倘	倘	tõng
淌	淌	tõng
儻	傥	tõng
帑	帑	tõng
躺	躺	tõng
捅	捅	tõnk
桶	桶	tõnk
統	统	tõnk
筒	筒	tõnk/tonk
討	讨	tõw
釷	钍	tõw
禱	祷	tõw
土	土	tõw
腿	腿	tõy
拖	拖	tö
苔	苔	töi
胎	胎	töi
禿	秃	tök
湯	汤	töng
通	通	tönk
湍	湍	tönt/jeün
饕	饕	töw
叨	叨	töw
韜	韬	töw
滔	滔	töw
推	推	töy
舔	舔	tĩm
腆	腆	tĩn
華	华	wa
驊	骅	wa
划	划	wa/wä
槐	槐	wai
淮	淮	wai
懷	怀	wai
鬟	鬟	wan
玩	玩	wan
寰	寰	wan
還	还	wan
環	环	wan
頑	顽	wan
橫	横	wang
弘	弘	wank
宏	宏	wank
閎	闳	wank
鋆	鋆	want
勻	匀	want
渾	浑	want
魂	魂	want
餛	馄	want
云	云	want
妘	妘	want
芸	芸	want
紜	纭	want
蕓	芸	want
昀	昀	want
琿	珲	want
筠	筠	want
暈	晕	want
耘	耘	want
雲	云	want
違	违	way
維	维	way
圍	围	way
惟	惟	way
為	为	way
帷	帷	way
唯	唯	way
闈	闱	way
濰	潍	way
桅	桅	way
遺	遗	way
嶸	嵘	wenk
榮	荣	wenk
禾	禾	wo
和	和	wo
隍	隍	wong
徨	徨	wong
簧	簧	wong
王	王	wong
凰	凰	wong
煌	煌	wong
潢	潢	wong
遑	遑	wong
黃	黄	wong
惶	惶	wong
磺	磺	wong
皇	皇	wong
蟥	蟥	wong
蝗	蝗	wong
鶘	鹕	wu
衚	胡	wu
鬍	胡	wu
餬	糊	wu
煳	煳	wu
猢	猢	wu
瑚	瑚	wu
蝴	蝴	wu
狐	狐	wu
湖	湖	wu
弧	弧	wu
胡	胡	wu
壺	壶	wu
糊	糊	wu
葫	葫	wu
醐	醐	wu
洄	洄	wui
徊	徊	wui
迴	回	wui
回	回	wui
蛔	蛔	wui
桓	桓	wun
垣	垣	wun
援	援	wun/yeun
華	华	wà
話	话	wà
樺	桦	wà/wa
滑	滑	wàd
猾	猾	wàd
惑	惑	wàg
畫	画	wàg
劃	划	wàg
或	或	wàg
壞	坏	wài
患	患	wàn
幻	幻	wàn
宦	宦	wàn
橫	横	wàng
鄆	郓	wànt
諢	诨	wànt
運	运	wànt
暈	晕	wànt
混	混	wànt
熨	熨	wànt
韻	韵	wànt/wánt
鷸	鹬	wàt
聿	聿	wàt/lòt
渭	渭	wày
位	位	wày
惠	惠	wày
謂	谓	wày
衛	卫	wày
胃	胃	wày
為	为	wày
蕙	蕙	wày
彗	彗	wày
蝟	猬	wày
慧	慧	wày
踝	踝	wá
輓	挽	wán
挽	挽	wán
允	允	wánt
殞	殒	wánt
尹	尹	wánt
隕	陨	wánt
狁	狁	wánt
瑋	玮	wáy
韙	韪	wáy
諱	讳	wáy
葦	苇	wáy
緯	纬	wáy
偉	伟	wáy
韋	韦	wáy
挖	挖	wâd
斡	斡	wâd
蘊	蕴	wânt
慍	愠	wânt
醞	酝	wânt
搵	揾	wânt
喂	喂	wây
畏	畏	wây
尉	尉	wây
慰	慰	wây
蔚	蔚	wây
餵	喂	wây
穢	秽	wây
薈	荟	wây/wùi
話	话	wã
剮	剐	wã
畫	画	wã/wà
綰	绾	wãn
玩	玩	wãn
穩	稳	wãnt
萎	萎	wãy
喟	喟	wãy
痿	痿	wãy
卉	卉	wãy
猥	猥	wãy
委	委	wãy
毀	毁	wãy
譁	哗	wä
娃	娃	wä
哇	哇	wä
蛙	蛙	wä
凹	凹	wä
嘩	哗	wä
窪	洼	wä
歪	歪	wäi
彎	弯	wän
灣	湾	wän
氳	氲	wänt
溫	温	wänt
瘟	瘟	wänt
屈	屈	wät
鬱	郁	wät
委	委	wäy
威	威	wäy
逶	逶	wäy
崴	崴	wäy
葳	葳	wäy
蜮	蜮	wèk
閾	阈	wèk
域	域	wèk
詠	咏	wènk
泳	泳	wènk
穎	颖	wènk
潁	颍	wènk
永	永	wénk
扔	扔	wënk
禍	祸	wò
鑊	镬	wòg
穫	获	wòg
獲	获	wòg
旺	旺	wòng
往	往	wóng
枉	枉	wõng
窩	窝	wö
倭	倭	wö
鍋	锅	wö
撾	挝	wö
媧	娲	wö
萵	莴	wö
渦	涡	wö
蝸	蜗	wö
窠	窠	wö/fö
汪	汪	wöng
怙	怙	wù
祜	祜	wù
戶	户	wù
芋	芋	wù
扈	扈	wù
互	互	wù
護	护	wù
滬	沪	wù
瓠	瓠	wù/wu
活	活	wùd
燴	烩	wùi
會	会	wùi
匯	汇	wùi
彙	汇	wùi/wày
會	会	wùi/wũi
緩	缓	wùn
喚	唤	wùn
奐	奂	wùn
瘓	痪	wùn
玩	玩	wùn
煥	焕	wùn
換	换	wùn
會	会	wúi
皖	皖	wún
浣	浣	wún
惡	恶	wû
污	污	wü
惡	恶	wü
嗚	呜	wü
鄔	邬	wü
烏	乌	wü
鎢	钨	wü
偎	偎	wüi
剜	剜	wün
滸	浒	wũ
塢	坞	wũ
腕	腕	wũn
碗	碗	wũn
莞	莞	wũn
玩	玩	wũn/wùn
豌	豌	wũn/wün
惋	惋	wũn/yeũn
霪	霪	yamp
壬	壬	yamp
任	任	yamp
吟	吟	yamp
淫	淫	yamp
仁	仁	yant
夤	夤	yant
寅	寅	yant
人	人	yant
猶	犹	yaw
游	游	yaw
蹂	蹂	yaw
鈾	铀	yaw
遊	游	yaw
酋	酋	yaw
蚰	蚰	yaw
尤	尤	yaw
攸	攸	yaw
由	由	yaw
悠	悠	yaw
揉	揉	yaw
油	油	yaw
疣	疣	yaw
郵	邮	yaw
魷	鱿	yaw
柔	柔	yaw
椰	椰	ye
邪	邪	ye
爺	爷	ye
揶	揶	ye
耶	耶	ye
贏	赢	yeng
滎	荥	yenk
盈	盈	yenk
瑩	莹	yenk
凝	凝	yenk
型	型	yenk
熒	荧	yenk
陘	陉	yenk
迎	迎	yenk
鎣	蓥	yenk
嬴	嬴	yenk
楹	楹	yenk
贏	赢	yenk
邢	邢	yenk
縈	萦	yenk
瀛	瀛	yenk
仍	仍	yenk
營	营	yenk
瀠	潆	yenk
形	形	yenk
刑	刑	yenk
蠅	蝇	yenk
螢	萤	yenk
瀅	滢	yenk/yènk
徉	徉	yeong
陽	阳	yeong
羊	羊	yeong
颺	飏	yeong
瘍	疡	yeong
烊	烊	yeong
楊	杨	yeong
揚	扬	yeong
瀼	瀼	yeong
禳	禳	yeong
穰	穰	yeong
蘘	蘘	yeong
洋	洋	yeong
暘	旸	yeong
佯	佯	yeong
萸	萸	yeu
揄	揄	yeu
逾	逾	yeu
臾	臾	yeu
虞	虞	yeu
俞	俞	yeu
如	如	yeu
隅	隅	yeu
竽	竽	yeu
濡	濡	yeu
愚	愚	yeu
妤	妤	yeu
愉	愉	yeu
瑜	瑜	yeu
踰	逾	yeu
予	予	yeu
禺	禺	yeu
儒	儒	yeu
榆	榆	yeu
蝓	蝓	yeu
于	于	yeu
蠕	蠕	yeu
余	余	yeu
歟	欤	yeu
魚	鱼	yeu
盂	盂	yeu
漁	渔	yeu
娛	娱	yeu
嚅	嚅	yeu
狳	狳	yeu
茹	茹	yeu
諛	谀	yeu
覦	觎	yeu
渝	渝	yeu
輿	舆	yeu
餘	余	yeu
孺	孺	yeu/yeù
元	元	yeun
袁	袁	yeun
轅	辕	yeun
圓	圆	yeun
猿	猿	yeun
眩	眩	yeun
緣	缘	yeun
烷	烷	yeun
懸	悬	yeun
原	原	yeun
沿	沿	yeun
員	员	yeun
鉛	铅	yeun
玄	玄	yeun
紈	纨	yeun
芫	芫	yeun
完	完	yeun
園	园	yeun
源	源	yeun
沅	沅	yeun
丸	丸	yeun/yeũn
瘧	疟	yeòg
龠	龠	yeòg
鑰	钥	yeòg
蒻	蒻	yeòg
弱	弱	yeòg
躍	跃	yeòg
謔	谑	yeòg
虐	虐	yeòg
若	若	yeòg
藥	药	yeòg
籥	籥	yeòg
恙	恙	yeòng
讓	让	yeòng
樣	样	yeòng
漾	漾	yeòng
釀	酿	yeòng
壤	壤	yeòng
氧	氧	yeóng
癢	痒	yeóng
仰	仰	yeóng
養	养	yeóng
攘	攘	yeóng
嚷	嚷	yeóng/yeòng
約	约	yeôg
鞅	鞅	yeõng
殃	殃	yeöng
央	央	yeöng
鴦	鸯	yeöng
秧	秧	yeöng
癒	愈	yeù
蕷	蓣	yeù
譽	誉	yeù
預	预	yeù
遇	遇	yeù
馭	驭	yeù
愈	愈	yeù
御	御	yeù
裕	裕	yeù
寓	寓	yeù
豫	豫	yeù
與	与	yeù
語	语	yeù
籲	吁	yeù
禦	御	yeù
喻	喻	yeù
諭	谕	yeù
鉞	钺	yeùd
釔	钇	yeùd
越	越	yeùd
穴	穴	yeùd
閱	阅	yeùd
曰	曰	yeùd
月	月	yeùd
悅	悦	yeùd
粵	粤	yeùd
乙	乙	yeùd/yeûd
縣	县	yeùn
願	愿	yeùn
媛	媛	yeùn
院	院	yeùn
炫	炫	yeùn/yeun
遠	远	yeùn/yeún
齬	龉	yeú
瑀	瑀	yeú
圄	圄	yeú
汝	汝	yeú
雨	雨	yeú
禹	禹	yeú
羽	羽	yeú
宇	宇	yeú
與	与	yeú
乳	乳	yeú
貐	貐	yeú
敔	敔	yeú
語	语	yeú
予	予	yeú
遠	远	yeún
阮	阮	yeún
軟	软	yeún
酗	酗	yeû/hõy/hôy
怨	怨	yeûn
淤	淤	yeü
於	于	yeü
迂	迂	yeü
冤	冤	yeün
蜿	蜿	yeün
鳶	鸢	yeün
淵	渊	yeün
鴛	鸳	yeün
嫗	妪	yeũ
傴	伛	yeũ
瘀	瘀	yeũ
菀	菀	yeũn
婉	婉	yeũn
苑	苑	yeũn
宛	宛	yeũn
琬	琬	yeũn
移	移	yi
胰	胰	yi
痍	痍	yi
兒	儿	yi
貽	贻	yi
疑	疑	yi
詒	诒	yi
怡	怡	yi
而	而	yi
誼	谊	yi
頤	颐	yi
飴	饴	yi
迤	迤	yi
儀	仪	yi
夷	夷	yi
宜	宜	yi
咦	咦	yi
彞	彝	yi
沂	沂	yi
眙	眙	yi
蛇	蛇	yi
姨	姨	yi
閻	阎	yim
嫌	嫌	yim
蚺	蚺	yim
髯	髯	yim
嚴	严	yim
炎	炎	yim
閆	闫	yim
鹽	盐	yim
簷	檐	yim/sim
舷	舷	yin
然	然	yin
賢	贤	yin
研	研	yin
涎	涎	yin
言	言	yin
弦	弦	yin
延	延	yin
燃	燃	yin
筵	筵	yin
妍	妍	yin
蜒	蜒	yin
焉	焉	yin
徭	徭	yiu
搖	摇	yiu
姚	姚	yiu
謠	谣	yiu
鰩	鳐	yiu
饒	饶	yiu
颻	飖	yiu
嬈	娆	yiu
洮	洮	yiu
遙	遥	yiu
窯	窑	yiu
堯	尧	yiu
瑤	瑶	yiu
傭	佣	yonk
榕	榕	yonk
茸	茸	yonk
蓉	蓉	yonk
鏞	镛	yonk
熔	熔	yonk
庸	庸	yonk
融	融	yonk
溶	溶	yonk
慵	慵	yonk
容	容	yonk
鱅	鳙	yonk
戎	戎	yonk
絨	绒	yonk/yõnk
蕤	蕤	yoy
飪	饪	yàmp
妊	妊	yàmp
任	任	yàmp
衽	衽	yàmp
賃	赁	yàmp
任	任	yàmp
胤	胤	yànt
孕	孕	yànt
釁	衅	yànt
刃	刃	yànt
紉	纫	yànt
韌	韧	yànt/ngànk
入	入	yàp
溢	溢	yàt
日	日	yàt
軼	轶	yàt
逸	逸	yàt
右	右	yàw
釉	釉	yàw
鼬	鼬	yàw
狖	狖	yàw
佑	佑	yàw
侑	侑	yàw
宥	宥	yàw
囿	囿	yàw
又	又	yàw
曳	曳	yày
跩	跩	yày
也	也	yá
荏	荏	yámp/yàmp
蚓	蚓	yánt
引	引	yánt
友	友	yáw
有	有	yáw
誘	诱	yáw
酉	酉	yáw
蔭	荫	yâmp
窨	窨	yâmp
印	印	yânt
幼	幼	yâw
飲	饮	yãmp
隱	隐	yãnt
忍	忍	yãnt
癮	瘾	yãnt
柚	柚	yãw
黝	黝	yãw
欽	钦	yämp
歆	歆	yämp
鑫	鑫	yämp
陰	阴	yämp
音	音	yämp
茵	茵	yänt
恩	恩	yänt
氤	氤	yänt
因	因	yänt
堙	堙	yänt
姻	姻	yänt
甄	甄	yänt
昕	昕	yänt
殷	殷	yänt
忻	忻	yänt
欣	欣	yänt
悒	悒	yäp
揖	揖	yäp
邑	邑	yäp
挹	挹	yäp
翕	翕	yäp
熠	熠	yäp
泣	泣	yäp
壹	壹	yät
一	一	yät
鵂	鸺	yäw
優	优	yäw
蚯	蚯	yäw
貅	貅	yäw
髹	髹	yäw
邱	邱	yäw
憂	忧	yäw
幽	幽	yäw
休	休	yäw
丘	丘	yäw
咻	咻	yäw
夜	夜	yè
偌	偌	yè
腋	腋	yèk
驛	驿	yèk
奕	奕	yèk
翼	翼	yèk
翊	翊	yèk
弈	弈	yèk
亦	亦	yèk
蜴	蜴	yèk
役	役	yèk
疫	疫	yèk
易	易	yèk
弋	弋	yèk
掖	掖	yèk
液	液	yèk
繹	绎	yèk
譯	译	yèk
翌	翌	yèk
逆	逆	yèk/ngàg
認	认	yènk
惹	惹	yé
野	野	yé
冶	冶	yé
郢	郢	yénk
應	应	yênk
億	亿	yëk
臆	臆	yëk
益	益	yëk
抑	抑	yëk
憶	忆	yëk
鬩	阋	yëk
嬰	婴	yënk
鷹	鹰	yënk
鸚	鹦	yënk
英	英	yënk
櫻	樱	yënk
應	应	yënk
纓	缨	yënk
膺	膺	yënk
瑛	瑛	yënk
二	二	yì
易	易	yì
肄	肄	yì
異	异	yì
貳	贰	yì
劓	劓	yì
義	义	yì
頁	页	yìb
業	业	yìb
葉	叶	yìb
燁	烨	yìb
拽	拽	yìd
孽	孽	yìd
熱	热	yìd
臬	臬	yìd/nìb
焰	焰	yìm
驗	验	yìm
艷	艳	yìm
讞	谳	yìn
現	现	yìn
硯	砚	yìn
諺	谚	yìn
莧	苋	yìn
彥	彦	yìn
唁	唁	yìn
曜	曜	yìu
鷂	鹞	yìu
耀	耀	yìu
邇	迩	yí
以	以	yí
洱	洱	yí
爾	尔	yí
耳	耳	yí
議	议	yí
迤	迤	yí
已	已	yí
擬	拟	yí
矣	矣	yí
染	染	yím
苒	苒	yím
儼	俨	yím
冉	冉	yím
舀	舀	yíu
癔	癔	yî
鐿	镱	yî
懿	懿	yî
意	意	yî
薏	薏	yî
靨	靥	yîb
噎	噎	yîd
謁	谒	yîd
咽	咽	yîd
饜	餍	yîm
厭	厌	yîm
嚥	咽	yîn
宴	宴	yîn
燕	燕	yîn
要	要	yîu
銥	铱	yï
漪	漪	yï
醫	医	yï
衣	衣	yï
依	依	yï
伊	伊	yï
黟	黟	yï
禕	祎	yï
禕	祎	yï
猗	猗	yï
奄	奄	yïm
淹	淹	yïm
閹	阉	yïm
懨	恹	yïm
醃	腌	yïm/yîb
蔫	蔫	yïn
湮	湮	yïn
菸	烟	yïn
胭	胭	yïn
焉	焉	yïn
咽	咽	yïn
鄢	鄢	yïn
嫣	嫣	yïn
燕	燕	yïn
煙	烟	yïn
閼	阏	yïn
要	要	yïu
吆	吆	yïu
邀	邀	yïu
夭	夭	yïu
么	幺	yïu
腰	腰	yïu
妖	妖	yïu
鈺	钰	yòk
褥	褥	yòk
蓐	蓐	yòk
浴	浴	yòk
辱	辱	yòk
育	育	yòk
獄	狱	yòk
肉	肉	yòk
鬻	鬻	yòk
縟	缛	yòk
慾	欲	yòk
玉	玉	yòk
欲	欲	yòk
峪	峪	yòk/yeù
用	用	yònk
潤	润	yònt
閏	闰	yònt
裔	裔	yòy
銳	锐	yòy
芮	芮	yòy
睿	睿	yòy
勇	勇	yónk
蕊	蕊	yóy
踴	踊	yõnk
蛹	蛹	yõnk
臃	臃	yõnk
湧	涌	yõnk
佣	佣	yõnk
俑	俑	yõnk
慂	恿	yõnk
擁	拥	yõnk
冗	冗	yõnk
喲	哟	yö
唷	唷	yö
煜	煜	yök
頊	顼	yök
旭	旭	yök
毓	毓	yök
郁	郁	yök
彧	彧	yök
昱	昱	yök
沃	沃	yök
饔	饔	yönk
翁	翁	yönk
雍	雍	yönk
嗡	嗡	yönk
邕	邕	yönk
廱	廱	yönk
倚	倚	yĩ
椅	椅	yĩ
綺	绮	yĩ
旖	旖	yĩ
齮	齮	yĩ
魘	魇	yĩm
掩	掩	yĩm
偃	偃	yĩn
兗	兖	yĩn
演	演	yĩn
鼴	鼹	yĩn
堰	堰	yĩn
衍	衍	yĩn/hĩn
窈	窈	yĩu
夭	夭	yĩu
擾	扰	yĩu
繞	绕	yĩu/yíu
影	影	yẽnk
映	映	yẽnk
氬	氩	â
啊	啊	â
婭	娅	â
亞	亚	â
阿	阿	â
鴨	鸭	âb
揠	揠	âd
軋	轧	âd
猰	猰	âd
壓	压	âd
遏	遏	âd
押	押	âd
隘	隘	âi
暗	暗	âmp
晏	晏	ân
拗	拗	âu
坳	坳	âu/äu
慪	怄	âw
凹	凹	âw/näp
屭	屃	ây
唉	唉	ây
縊	缢	ây
啞	哑	ã
啊	啊	ã
黯	黯	ãmp
揞	揞	ãmp
俺	俺	ãn
嘔	呕	ãw
毆	殴	ãw/äw
矮	矮	ãy
呀	呀	ä
吖	吖	ä
鴉	鸦	ä
啊	啊	ä
錒	锕	ä
丫	丫	ä
軛	轭	äg
挨	挨	äi
厄	厄	äk/äg
渥	渥	äk/äg
齷	龌	äk/äg
握	握	äk/äg
扼	扼	äk/äg
幄	幄	äk/äg
諳	谙	ämp
鵪	鹌	ämp
庵	庵	ämp
罌	罂	äng
鶯	莺	änk
罌	罂	änk
甌	瓯	äw
歐	欧	äw
鷗	鸥	äw
唉	唉	äy
哎	哎	äy
欸	欸	èy
欸	欸	ëy
嗯	嗯	ñg
哦	哦	ò
惡	恶	ôg
堊	垩	ôg
噁	恶	ôg
璦	瑷	ôi
愛	爱	ôi
摁	摁	ôn
案	案	ôn
按	按	ôn
甕	瓮	ônk
齆	齆	ônk
藹	蔼	õi
曖	暧	õi
靉	叆	õi
毐	毐	õi
媼	媪	õw
阿	阿	ö
珂	珂	ö
柯	柯	ö
軻	轲	ö
喔	喔	ö
噢	噢	ö
婀	婀	ö
哀	哀	öi
埃	埃	öi
屋	屋	ök
銨	铵	ön
桉	桉	ön
氨	氨	ön
安	安	ön
胺	胺	ön
鞍	鞍	ön
忤	忤	ńg
午	午	ńg
伍	伍	ńg
牾	牾	ńg
五	五	ńg
晤	晤	ǹg
焐	焐	ǹg
誤	误	ǹg
悟	悟	ǹg
摀	捂	ǹg
嗯	嗯	ǹg
欸	欸	ẽy
